"state","date","year","fatalities","injured","total_victims"
"Alabama","04/07/2009","2009",4,0,4
"Alabama","03/10/2009","2009",10,6,16
"Alabama","01/29/2012","2012",5,0,5
"Alabama","12/28/2013","2013",3,5,8
"Alabama","07/06/2013","2013",0,4,4
"Alabama","06/08/2014","2014",1,4,5
"Alabama","01/12/2014","2014",0,5,5
"Alabama","12/25/2015","2015",0,4,4
"Alabama","11/16/2015","2015",3,1,4
"Alabama","05/24/2015","2015",1,3,4
"Alabama","04/18/2015","2015",0,5,5
"Alabama","12/25/2016","2016",0,4,4
"Alabama","12/23/2016","2016",1,3,4
"Alabama","10/15/2016","2016",0,5,5
"Alabama","08/28/2016","2016",0,5,5
"Alabama","08/27/2016","2016",1,6,7
"Alabama","08/20/2016","2016",5,0,5
"Alabama","05/11/2016","2016",1,4,5
"Alabama","05/06/2016","2016",1,3,4
"Alabama","04/23/2016","2016",3,1,4
"Alabama","04/19/2016","2016",1,4,5
"Alabama","04/16/2016","2016",0,4,4
"Alabama","04/09/2016","2016",0,4,4
"Alabama","03/19/2016","2016",2,2,4
"Alabama","02/20/2016","2016",1,3,4
"Alabama","02/14/2016","2016",0,5,5
"Alabama","12/24/2017","2017",1,4,5
"Alabama","12/23/2017","2017",0,4,4
"Alabama","10/22/2017","2017",2,7,9
"Alabama","09/09/2017","2017",0,4,4
"Alabama","07/03/2017","2017",3,1,4
"Alabama","05/28/2017","2017",0,12,12
"Alabama","04/15/2017","2017",0,6,6
"Alabama","11/25/2018","2018",2,2,4
"Alabama","10/08/2018","2018",0,4,4
"Alabama","09/09/2018","2018",1,4,5
"Alabama","09/02/2018","2018",0,7,7
"Alabama","07/08/2018","2018",0,6,6
"Alabama","07/07/2018","2018",3,2,5
"Alabama","06/19/2018","2018",0,4,4
"Alabama","06/11/2018","2018",0,4,4
"Alabama","04/01/2018","2018",1,4,5
"Alabama","03/07/2018","2018",2,2,4
"Alabama","01/14/2018","2018",1,4,5
"Alabama","01/14/2018","2018",0,4,4
"Alabama","01/07/2018","2018",1,5,6
"Alabama","01/01/2018","2018",1,3,4
"Alabama","12/20/2019","2019",2,2,4
"Alabama","12/04/2019","2019",2,2,4
"Alabama","11/24/2019","2019",1,4,5
"Alabama","09/02/2019","2019",5,0,5
"Alabama","09/01/2019","2019",0,7,7
"Alabama","08/30/2019","2019",0,9,9
"Alabama","08/15/2019","2019",2,3,5
"Alabama","05/18/2019","2019",1,8,9
"Alabama","04/28/2019","2019",0,4,4
"Alabama","03/15/2019","2019",2,4,6
"Alabama","02/22/2019","2019",2,2,4
"Alabama","01/27/2019","2019",0,5,5
"Alabama","09/26/2020","2020",1,3,4
"Alabama","08/22/2020","2020",1,3,4
"Alabama","08/15/2020","2020",2,3,5
"Alabama","08/08/2020","2020",1,5,6
"Alabama","08/01/2020","2020",0,4,4
"Alabama","07/03/2020","2020",1,3,4
"Alabama","06/28/2020","2020",0,7,7
"Alabama","06/21/2020","2020",0,4,4
"Alabama","06/04/2020","2020",7,0,7
"Alabama","05/24/2020","2020",3,1,4
"Alabama","05/11/2020","2020",0,4,4
"Alaska","09/14/2014","2014",0,6,6
"Alaska","11/30/2020","2020",4,0,4
"Alaska","10/07/2020","2020",1,4,5
"Alaska","04/08/2020","2020",0,4,4
"Arizona","05/16/2006","2006",4,0,4
"Arizona","02/21/2006","2006",5,0,5
"Arizona","08/28/2010","2010",5,1,6
"Arizona","01/08/2011","2011",6,13,19
"Arizona","06/02/2011","2011",5,1,6
"Arizona","06/02/2012","2012",4,0,4
"Arizona","05/02/2012","2012",4,0,4
"Arizona","11/10/2013","2013",1,3,4
"Arizona","10/06/2013","2013",0,4,4
"Arizona","05/12/2013","2013",0,5,5
"Arizona","04/14/2013","2013",2,4,6
"Arizona","10/26/2013","2013",4,0,4
"Arizona","04/05/2014","2014",1,3,4
"Arizona","10/25/2015","2015",1,4,5
"Arizona","10/09/2015","2015",1,3,4
"Arizona","05/12/2015","2015",5,0,5
"Arizona","04/27/2015","2015",2,2,4
"Arizona","04/16/2015","2015",5,0,5
"Arizona","03/18/2015","2015",1,5,6
"Arizona","07/04/2016","2016",2,6,8
"Arizona","06/05/2016","2016",2,4,6
"Arizona","02/23/2016","2016",5,0,5
"Arizona","01/30/2016","2016",3,5,8
"Arizona","02/23/2016","2016",4,0,4
"Arizona","10/15/2017","2017",1,3,4
"Arizona","10/07/2017","2017",0,4,4
"Arizona","10/05/2017","2017",4,0,4
"Arizona","07/18/2017","2017",0,4,4
"Arizona","05/21/2017","2017",0,4,4
"Arizona","11/11/2018","2018",3,1,4
"Arizona","07/29/2018","2018",1,4,5
"Arizona","05/30/2018","2018",6,0,6
"Arizona","11/01/2019","2019",0,5,5
"Arizona","04/11/2019","2019",3,2,5
"Arizona","03/24/2019","2019",0,7,7
"Arizona","03/19/2019","2019",2,4,6
"Arizona","01/13/2019","2019",1,5,6
"Arizona","01/03/2019","2019",1,3,4
"Arizona","11/21/2020","2020",1,4,5
"Arizona","11/01/2020","2020",2,2,4
"Arizona","10/16/2020","2020",1,6,7
"Arizona","06/26/2020","2020",0,4,4
"Arkansas","03/24/1998","1998",5,10,15
"Arkansas","11/12/2009","2009",5,1,6
"Arkansas","07/26/2014","2014",1,3,4
"Arkansas","05/03/2014","2014",4,4,8
"Arkansas","08/08/2015","2015",1,11,12
"Arkansas","02/17/2015","2015",1,3,4
"Arkansas","11/02/2016","2016",1,4,5
"Arkansas","09/08/2016","2016",1,4,5
"Arkansas","07/19/2016","2016",0,4,4
"Arkansas","07/01/2017","2017",0,25,25
"Arkansas","05/14/2017","2017",1,6,7
"Arkansas","02/07/2017","2017",1,4,5
"Arkansas","11/16/2018","2018",3,1,4
"Arkansas","10/28/2018","2018",2,2,4
"Arkansas","09/02/2018","2018",0,4,4
"Arkansas","08/27/2018","2018",1,3,4
"Arkansas","04/25/2018","2018",0,4,4
"Arkansas","01/04/2018","2018",1,3,4
"Arkansas","11/30/2019","2019",0,5,5
"Arkansas","11/10/2019","2019",0,4,4
"Arkansas","03/02/2019","2019",1,4,5
"Arkansas","01/15/2019","2019",1,4,5
"Arkansas","01/02/2019","2019",1,3,4
"Arkansas","12/25/2020","2020",5,0,5
"Arkansas","09/19/2020","2020",0,5,5
"Arkansas","09/18/2020","2020",0,4,4
"Arkansas","09/05/2020","2020",0,4,4
"Arkansas","09/03/2020","2020",1,3,4
"Arkansas","09/03/2020","2020",0,4,4
"Arkansas","08/23/2020","2020",0,7,7
"Arkansas","07/26/2020","2020",0,4,4
"Arkansas","07/05/2020","2020",1,3,4
"Arkansas","06/30/2020","2020",0,4,4
"Arkansas","06/27/2020","2020",3,1,4
"Arkansas","06/13/2020","2020",0,4,4
"Arkansas","06/07/2020","2020",0,5,5
"California","05/01/1992","1992",4,10,14
"California","07/01/1993","1993",9,6,15
"California","12/18/1997","1997",5,2,7
"California","01/30/2006","2006",8,0,8
"California","08/23/2006","2006",4,0,4
"California","07/04/2006","2006",4,0,4
"California","11/11/2007","2007",4,0,4
"California","04/10/2007","2007",5,0,5
"California","12/24/2008","2008",9,3,12
"California","11/02/2008","2008",5,0,5
"California","10/05/2008","2008",5,0,5
"California","03/18/2008","2008",4,0,4
"California","02/23/2008","2008",4,1,5
"California","02/07/2008","2008",4,1,5
"California","03/29/2009","2009",5,1,6
"California","03/21/2009","2009",4,1,5
"California","01/27/2009","2009",6,0,6
"California","04/03/2010","2010",4,2,6
"California","10/12/2011","2011",8,1,9
"California","02/11/2011","2011",4,0,4
"California","04/02/2012","2012",7,3,10
"California","12/08/2012","2012",4,2,6
"California","12/02/2012","2012",4,0,4
"California","06/07/2013","2013",6,3,9
"California","11/29/2013","2013",0,4,4
"California","11/25/2013","2013",0,7,7
"California","11/03/2013","2013",1,3,4
"California","11/03/2013","2013",0,5,5
"California","10/27/2013","2013",1,6,7
"California","10/27/2013","2013",0,4,4
"California","10/05/2013","2013",1,12,13
"California","09/20/2013","2013",2,2,4
"California","09/17/2013","2013",2,3,5
"California","08/25/2013","2013",0,4,4
"California","08/17/2013","2013",0,4,4
"California","08/04/2013","2013",3,4,7
"California","07/19/2013","2013",0,4,4
"California","07/17/2013","2013",1,3,4
"California","07/12/2013","2013",1,3,4
"California","07/07/2013","2013",1,4,5
"California","06/27/2013","2013",2,2,4
"California","06/23/2013","2013",1,3,4
"California","06/01/2013","2013",2,2,4
"California","05/24/2013","2013",2,2,4
"California","05/10/2013","2013",3,1,4
"California","05/05/2013","2013",0,5,5
"California","04/10/2013","2013",0,4,4
"California","04/07/2013","2013",1,3,4
"California","03/30/2013","2013",3,2,5
"California","03/17/2013","2013",2,3,5
"California","03/16/2013","2013",0,7,7
"California","03/14/2013","2013",0,4,4
"California","03/13/2013","2013",2,2,4
"California","03/04/2013","2013",1,3,4
"California","02/23/2013","2013",0,4,4
"California","02/19/2013","2013",4,3,7
"California","02/11/2013","2013",1,4,5
"California","02/03/2013","2013",1,3,4
"California","01/21/2013","2013",0,4,4
"California","01/01/2013","2013",1,3,4
"California","05/23/2014","2014",6,13,19
"California","02/20/2014","2014",4,2,6
"California","12/27/2014","2014",1,3,4
"California","12/27/2014","2014",0,4,4
"California","11/26/2014","2014",0,6,6
"California","11/08/2014","2014",0,5,5
"California","11/07/2014","2014",0,4,4
"California","11/07/2014","2014",0,4,4
"California","11/05/2014","2014",0,4,4
"California","10/12/2014","2014",3,1,4
"California","10/04/2014","2014",0,4,4
"California","09/29/2014","2014",0,4,4
"California","09/03/2014","2014",0,6,6
"California","09/02/2014","2014",0,5,5
"California","08/31/2014","2014",0,5,5
"California","08/24/2014","2014",4,5,9
"California","08/17/2014","2014",1,3,4
"California","08/10/2014","2014",0,7,7
"California","08/06/2014","2014",3,1,4
"California","07/14/2014","2014",1,4,5
"California","07/12/2014","2014",3,2,5
"California","07/07/2014","2014",1,4,5
"California","06/29/2014","2014",1,5,6
"California","06/28/2014","2014",0,7,7
"California","06/27/2014","2014",1,3,4
"California","06/22/2014","2014",1,3,4
"California","06/13/2014","2014",3,1,4
"California","06/01/2014","2014",0,4,4
"California","05/31/2014","2014",1,3,4
"California","05/23/2014","2014",4,7,11
"California","05/23/2014","2014",2,2,4
"California","05/17/2014","2014",1,3,4
"California","05/10/2014","2014",1,6,7
"California","04/22/2014","2014",1,3,4
"California","04/05/2014","2014",0,4,4
"California","03/23/2014","2014",0,7,7
"California","03/23/2014","2014",1,3,4
"California","03/08/2014","2014",1,3,4
"California","02/22/2014","2014",0,4,4
"California","02/12/2014","2014",1,3,4
"California","02/12/2014","2014",1,3,4
"California","01/14/2014","2014",0,4,4
"California","05/23/2014","2014",6,14,20
"California","12/02/2015","2015",14,21,35
"California","12/21/2015","2015",0,4,4
"California","12/13/2015","2015",1,3,4
"California","12/13/2015","2015",0,4,4
"California","11/27/2015","2015",2,2,4
"California","11/18/2015","2015",0,5,5
"California","11/06/2015","2015",0,4,4
"California","08/27/2015","2015",2,2,4
"California","08/23/2015","2015",1,7,8
"California","08/15/2015","2015",0,4,4
"California","08/10/2015","2015",0,4,4
"California","07/18/2015","2015",0,4,4
"California","07/18/2015","2015",0,5,5
"California","07/13/2015","2015",0,4,4
"California","07/13/2015","2015",1,4,5
"California","06/10/2015","2015",1,3,4
"California","05/30/2015","2015",0,4,4
"California","05/23/2015","2015",2,2,4
"California","03/17/2015","2015",3,4,7
"California","03/15/2015","2015",0,4,4
"California","03/14/2015","2015",0,4,4
"California","03/04/2015","2015",3,4,7
"California","02/20/2015","2015",0,4,4
"California","02/15/2015","2015",0,5,5
"California","01/26/2015","2015",1,3,4
"California","01/11/2015","2015",0,5,5
"California","01/09/2015","2015",4,0,4
"California","12/12/2016","2016",1,3,4
"California","12/09/2016","2016",0,4,4
"California","12/03/2016","2016",0,6,6
"California","12/01/2016","2016",1,3,4
"California","11/28/2016","2016",0,4,4
"California","11/28/2016","2016",0,4,4
"California","11/13/2016","2016",3,2,5
"California","11/12/2016","2016",1,5,6
"California","11/05/2016","2016",0,8,8
"California","10/29/2016","2016",0,5,5
"California","10/29/2016","2016",0,4,4
"California","10/22/2016","2016",0,7,7
"California","10/18/2016","2016",0,4,4
"California","10/15/2016","2016",4,11,15
"California","10/09/2016","2016",1,3,4
"California","10/01/2016","2016",0,4,4
"California","09/29/2016","2016",1,3,4
"California","09/16/2016","2016",2,2,4
"California","08/17/2016","2016",0,4,4
"California","08/13/2016","2016",0,4,4
"California","08/10/2016","2016",1,3,4
"California","08/07/2016","2016",1,3,4
"California","08/05/2016","2016",2,2,4
"California","07/20/2016","2016",0,4,4
"California","07/16/2016","2016",1,14,15
"California","07/16/2016","2016",0,4,4
"California","07/14/2016","2016",0,4,4
"California","07/05/2016","2016",0,4,4
"California","06/28/2016","2016",1,3,4
"California","06/14/2016","2016",1,3,4
"California","06/13/2016","2016",0,4,4
"California","06/11/2016","2016",1,3,4
"California","06/11/2016","2016",3,2,5
"California","06/06/2016","2016",0,4,4
"California","05/30/2016","2016",0,5,5
"California","05/22/2016","2016",1,3,4
"California","04/29/2016","2016",0,5,5
"California","04/18/2016","2016",1,3,4
"California","04/10/2016","2016",0,4,4
"California","03/12/2016","2016",0,4,4
"California","03/06/2016","2016",1,8,9
"California","02/28/2016","2016",1,3,4
"California","02/19/2016","2016",1,3,4
"California","02/06/2016","2016",1,3,4
"California","01/25/2016","2016",1,4,5
"California","01/23/2016","2016",2,2,4
"California","08/29/2016","2016",4,0,4
"California","11/14/2017","2017",5,10,15
"California","06/14/2017","2017",3,2,5
"California","12/15/2017","2017",0,5,5
"California","11/14/2017","2017",2,2,4
"California","11/14/2017","2017",6,12,18
"California","11/12/2017","2017",0,5,5
"California","11/04/2017","2017",1,3,4
"California","11/03/2017","2017",0,4,4
"California","10/27/2017","2017",0,4,4
"California","10/23/2017","2017",2,3,5
"California","10/12/2017","2017",2,2,4
"California","10/10/2017","2017",0,4,4
"California","09/23/2017","2017",1,4,5
"California","09/03/2017","2017",2,3,5
"California","08/27/2017","2017",1,4,5
"California","08/14/2017","2017",2,2,4
"California","08/13/2017","2017",0,4,4
"California","08/06/2017","2017",0,7,7
"California","08/01/2017","2017",0,7,7
"California","07/19/2017","2017",1,3,4
"California","07/01/2017","2017",0,4,4
"California","06/02/2017","2017",1,3,4
"California","04/30/2017","2017",2,6,8
"California","04/29/2017","2017",1,3,4
"California","04/29/2017","2017",0,5,5
"California","04/29/2017","2017",1,5,6
"California","04/29/2017","2017",0,4,4
"California","04/16/2017","2017",0,4,4
"California","04/15/2017","2017",0,4,4
"California","04/01/2017","2017",0,5,5
"California","03/24/2017","2017",1,4,5
"California","03/04/2017","2017",0,4,4
"California","03/03/2017","2017",0,5,5
"California","02/15/2017","2017",0,4,4
"California","01/20/2017","2017",0,4,4
"California","01/12/2017","2017",2,2,4
"California","01/06/2017","2017",2,2,4
"California","01/04/2017","2017",3,1,4
"California","11/07/2018","2018",12,22,34
"California","09/12/2018","2018",5,0,5
"California","12/08/2018","2018",0,5,5
"California","11/25/2018","2018",0,4,4
"California","11/18/2018","2018",1,4,5
"California","11/02/2018","2018",0,4,4
"California","10/30/2018","2018",2,3,5
"California","10/30/2018","2018",0,5,5
"California","10/29/2018","2018",0,7,7
"California","10/14/2018","2018",2,2,4
"California","10/06/2018","2018",0,6,6
"California","09/30/2018","2018",1,3,4
"California","09/23/2018","2018",1,4,5
"California","09/23/2018","2018",0,4,4
"California","09/02/2018","2018",0,8,8
"California","08/12/2018","2018",4,1,5
"California","08/11/2018","2018",1,4,5
"California","07/31/2018","2018",2,3,5
"California","07/28/2018","2018",2,4,6
"California","07/26/2018","2018",2,2,4
"California","07/05/2018","2018",3,3,6
"California","06/27/2018","2018",1,3,4
"California","06/21/2018","2018",1,3,4
"California","06/20/2018","2018",0,5,5
"California","06/14/2018","2018",0,5,5
"California","06/14/2018","2018",1,4,5
"California","06/10/2018","2018",0,6,6
"California","05/13/2018","2018",2,2,4
"California","05/13/2018","2018",3,2,5
"California","05/07/2018","2018",0,5,5
"California","04/20/2018","2018",1,5,6
"California","04/09/2018","2018",0,4,4
"California","03/21/2018","2018",1,5,6
"California","03/12/2018","2018",0,4,4
"California","01/27/2018","2018",0,5,5
"California","07/28/2019","2019",3,12,15
"California","12/29/2019","2019",0,5,5
"California","12/27/2019","2019",1,3,4
"California","12/25/2019","2019",0,4,4
"California","12/14/2019","2019",0,4,4
"California","11/24/2019","2019",0,6,6
"California","11/23/2019","2019",0,4,4
"California","11/21/2019","2019",0,5,5
"California","11/20/2019","2019",0,4,4
"California","11/17/2019","2019",4,6,10
"California","11/16/2019","2019",6,0,6
"California","11/14/2019","2019",3,3,6
"California","10/31/2019","2019",5,3,8
"California","10/29/2019","2019",3,9,12
"California","09/18/2019","2019",2,2,4
"California","09/14/2019","2019",1,4,5
"California","08/22/2019","2019",0,4,4
"California","08/10/2019","2019",0,4,4
"California","07/25/2019","2019",4,2,6
"California","07/06/2019","2019",0,4,4
"California","07/04/2019","2019",0,4,4
"California","07/04/2019","2019",1,3,4
"California","06/30/2019","2019",0,4,4
"California","06/30/2019","2019",0,5,5
"California","06/23/2019","2019",1,3,4
"California","06/23/2019","2019",5,0,5
"California","06/21/2019","2019",5,0,5
"California","06/21/2019","2019",0,5,5
"California","06/05/2019","2019",0,4,4
"California","05/31/2019","2019",1,3,4
"California","05/26/2019","2019",1,3,4
"California","05/18/2019","2019",1,4,5
"California","05/17/2019","2019",1,3,4
"California","05/14/2019","2019",0,4,4
"California","05/05/2019","2019",0,6,6
"California","05/04/2019","2019",1,4,5
"California","04/27/2019","2019",1,3,4
"California","04/27/2019","2019",0,6,6
"California","04/14/2019","2019",1,3,4
"California","04/14/2019","2019",0,4,4
"California","04/13/2019","2019",0,4,4
"California","04/11/2019","2019",1,4,5
"California","03/24/2019","2019",1,5,6
"California","03/03/2019","2019",0,4,4
"California","02/28/2019","2019",1,3,4
"California","02/03/2019","2019",4,0,4
"California","02/01/2019","2019",0,4,4
"California","01/16/2019","2019",3,1,4
"California","01/04/2019","2019",3,4,7
"California","07/25/2019","2019",4,2,6
"California","12/12/2020","2020",1,3,4
"California","12/05/2020","2020",1,3,4
"California","11/14/2020","2020",2,3,5
"California","10/31/2020","2020",0,4,4
"California","10/31/2020","2020",0,4,4
"California","10/16/2020","2020",2,4,6
"California","10/16/2020","2020",1,3,4
"California","10/03/2020","2020",1,3,4
"California","10/02/2020","2020",0,4,4
"California","09/27/2020","2020",1,3,4
"California","09/15/2020","2020",2,4,6
"California","09/07/2020","2020",7,0,7
"California","09/02/2020","2020",0,4,4
"California","08/24/2020","2020",1,3,4
"California","08/11/2020","2020",0,5,5
"California","08/06/2020","2020",1,3,4
"California","08/04/2020","2020",1,4,5
"California","07/25/2020","2020",0,7,7
"California","07/02/2020","2020",2,3,5
"California","07/01/2020","2020",0,4,4
"California","06/29/2020","2020",0,4,4
"California","06/27/2020","2020",3,4,7
"California","06/26/2020","2020",0,4,4
"California","06/22/2020","2020",0,5,5
"California","06/13/2020","2020",0,5,5
"California","06/10/2020","2020",2,4,6
"California","06/10/2020","2020",1,4,5
"California","06/09/2020","2020",2,3,5
"California","06/06/2020","2020",1,4,5
"California","05/27/2020","2020",0,5,5
"California","05/26/2020","2020",0,5,5
"California","05/18/2020","2020",0,5,5
"California","04/11/2020","2020",0,6,6
"California","04/05/2020","2020",1,3,4
"California","03/08/2020","2020",1,3,4
"California","03/04/2020","2020",1,5,6
"California","02/03/2020","2020",1,5,6
"California","01/31/2020","2020",1,4,5
"California","01/30/2020","2020",0,4,4
"Colorado","12/14/1993","1993",4,1,5
"Colorado","04/20/1999","1999",13,24,37
"Colorado","12/09/2007","2007",4,5,9
"Colorado","07/20/2012","2012",12,70,82
"Colorado","09/15/2013","2013",0,5,5
"Colorado","06/30/2013","2013",0,4,4
"Colorado","11/23/2014","2014",1,4,5
"Colorado","05/04/2014","2014",0,4,4
"Colorado","11/27/2015","2015",3,9,12
"Colorado","11/07/2015","2015",1,3,4
"Colorado","09/07/2015","2015",0,4,4
"Colorado","08/07/2016","2016",2,2,4
"Colorado","06/04/2016","2016",3,1,4
"Colorado","04/24/2016","2016",0,4,4
"Colorado","03/25/2016","2016",0,4,4
"Colorado","12/31/2017","2017",2,6,8
"Colorado","01/15/2017","2017",3,1,4
"Colorado","12/14/2018","2018",1,3,4
"Colorado","11/19/2018","2018",1,4,5
"Colorado","08/31/2018","2018",2,3,5
"Colorado","08/11/2018","2018",1,3,4
"Colorado","07/15/2018","2018",0,4,4
"Colorado","06/14/2018","2018",1,3,4
"Colorado","05/27/2018","2018",1,3,4
"Colorado","02/05/2018","2018",2,4,6
"Colorado","10/06/2019","2019",0,4,4
"Colorado","06/11/2019","2019",0,4,4
"Colorado","05/07/2019","2019",1,8,9
"Colorado","03/10/2019","2019",1,4,5
"Colorado","09/06/2020","2020",0,4,4
"Colorado","08/23/2020","2020",0,6,6
"Colorado","08/16/2020","2020",2,4,6
"Colorado","08/09/2020","2020",0,9,9
"Colorado","08/01/2020","2020",1,4,5
"Colorado","07/26/2020","2020",1,3,4
"Colorado","07/25/2020","2020",2,3,5
"Colorado","06/26/2020","2020",0,5,5
"Colorado","06/05/2020","2020",0,4,4
"Colorado","02/29/2020","2020",0,5,5
"Colorado","01/11/2020","2020",0,5,5
"Connecticut","03/06/1998","1998",5,1,6
"Connecticut","08/03/2010","2010",9,2,11
"Connecticut","12/14/2012","2012",27,2,29
"Connecticut","10/26/2013","2013",1,5,6
"Connecticut","09/10/2013","2013",1,4,5
"Connecticut","07/19/2013","2013",0,4,4
"Connecticut","07/13/2014","2014",0,5,5
"Connecticut","06/11/2015","2015",1,8,9
"Connecticut","05/31/2015","2015",0,5,5
"Connecticut","12/30/2016","2016",2,3,5
"Connecticut","11/12/2016","2016",0,5,5
"Connecticut","08/21/2016","2016",0,13,13
"Connecticut","08/20/2016","2016",0,4,4
"Connecticut","08/18/2016","2016",0,4,4
"Connecticut","06/24/2016","2016",0,5,5
"Connecticut","10/22/2017","2017",0,4,4
"Connecticut","09/23/2017","2017",2,2,4
"Connecticut","06/27/2018","2018",0,4,4
"Connecticut","02/27/2018","2018",0,4,4
"Connecticut","09/01/2019","2019",1,3,4
"Connecticut","06/29/2019","2019",0,4,4
"Connecticut","06/28/2019","2019",0,5,5
"Connecticut","12/20/2020","2020",2,2,4
"Connecticut","09/20/2020","2020",1,3,4
"Connecticut","08/15/2020","2020",1,5,6
"Connecticut","08/04/2020","2020",1,5,6
"Connecticut","06/25/2020","2020",1,3,4
"Connecticut","02/16/2020","2020",1,5,6
"Connecticut","01/27/2020","2020",0,4,4
"D.C.","09/16/2013","2013",12,8,20
"Delaware","12/07/2013","2013",0,4,4
"Delaware","08/10/2013","2013",0,4,4
"Delaware","02/11/2013","2013",3,2,5
"Delaware","06/28/2015","2015",0,6,6
"Delaware","06/14/2016","2016",0,4,4
"Delaware","01/11/2016","2016",1,4,5
"Delaware","07/28/2017","2017",0,4,4
"Delaware","07/09/2018","2018",5,0,5
"Delaware","07/09/2018","2018",4,0,4
"Delaware","05/04/2019","2019",0,4,4
"Delaware","04/07/2019","2019",0,6,6
"Delaware","07/28/2020","2020",2,2,4
"Delaware","07/11/2020","2020",0,5,5
"Delaware","02/10/2020","2020",1,4,5
"District of Columbia","03/30/2010","2010",4,5,9
"District of Columbia","11/06/2013","2013",1,3,4
"District of Columbia","09/16/2013","2013",13,3,16
"District of Columbia","09/12/2013","2013",1,3,4
"District of Columbia","07/13/2013","2013",0,4,4
"District of Columbia","03/11/2013","2013",0,13,13
"District of Columbia","01/26/2013","2013",0,5,5
"District of Columbia","09/16/2013","2013",12,3,15
"District of Columbia","08/10/2014","2014",0,6,6
"District of Columbia","08/08/2014","2014",0,4,4
"District of Columbia","07/13/2014","2014",0,4,4
"District of Columbia","06/21/2014","2014",0,4,4
"District of Columbia","05/17/2014","2014",0,5,5
"District of Columbia","04/14/2014","2014",0,4,4
"District of Columbia","10/25/2015","2015",0,5,5
"District of Columbia","07/17/2015","2015",1,3,4
"District of Columbia","07/04/2015","2015",1,3,4
"District of Columbia","09/17/2016","2016",2,7,9
"District of Columbia","07/11/2016","2016",0,4,4
"District of Columbia","06/08/2016","2016",0,4,4
"District of Columbia","02/03/2016","2016",0,4,4
"District of Columbia","01/08/2016","2016",0,4,4
"District of Columbia","08/03/2017","2017",1,3,4
"District of Columbia","06/25/2017","2017",0,4,4
"District of Columbia","06/18/2017","2017",0,4,4
"District of Columbia","05/27/2017","2017",1,7,8
"District of Columbia","01/31/2017","2017",0,4,4
"District of Columbia","09/21/2018","2018",0,4,4
"District of Columbia","07/16/2018","2018",1,4,5
"District of Columbia","07/03/2018","2018",0,4,4
"District of Columbia","04/30/2018","2018",0,4,4
"District of Columbia","01/25/2018","2018",0,4,4
"District of Columbia","01/17/2018","2018",1,3,4
"District of Columbia","09/19/2019","2019",1,5,6
"District of Columbia","07/28/2019","2019",0,4,4
"District of Columbia","07/21/2019","2019",0,4,4
"District of Columbia","07/08/2019","2019",2,2,4
"District of Columbia","05/27/2019","2019",0,5,5
"District of Columbia","05/26/2019","2019",1,3,4
"District of Columbia","02/04/2019","2019",0,5,5
"District of Columbia","10/05/2020","2020",1,3,4
"District of Columbia","08/09/2020","2020",1,21,22
"District of Columbia","08/04/2020","2020",0,4,4
"District of Columbia","07/19/2020","2020",1,8,9
"District of Columbia","06/13/2020","2020",2,5,7
"District of Columbia","06/11/2020","2020",0,7,7
"District of Columbia","05/30/2020","2020",0,4,4
"District of Columbia","03/06/2020","2020",0,6,6
"Florida","02/09/1996","1996",6,1,7
"Florida","12/30/1999","1999",5,3,8
"Florida","10/13/2006","2006",4,0,4
"Florida","12/14/2007","2007",4,0,4
"Florida","09/22/2007","2007",4,0,4
"Florida","11/26/2009","2009",4,2,6
"Florida","03/15/2009","2009",4,0,4
"Florida","11/19/2010","2010",4,0,4
"Florida","09/27/2010","2010",5,1,6
"Florida","06/16/2010","2010",4,3,7
"Florida","08/05/2011","2011",4,0,4
"Florida","05/15/2012","2012",4,0,4
"Florida","07/26/2013","2013",7,0,7
"Florida","12/15/2013","2013",1,3,4
"Florida","12/01/2013","2013",2,2,4
"Florida","11/05/2013","2013",4,0,4
"Florida","10/26/2013","2013",0,4,4
"Florida","10/20/2013","2013",2,2,4
"Florida","10/20/2013","2013",0,4,4
"Florida","09/21/2013","2013",0,4,4
"Florida","09/17/2013","2013",0,5,5
"Florida","08/25/2013","2013",4,1,5
"Florida","07/07/2013","2013",1,3,4
"Florida","04/27/2013","2013",1,3,4
"Florida","03/17/2013","2013",0,5,5
"Florida","11/07/2013","2013",4,0,4
"Florida","12/21/2014","2014",2,2,4
"Florida","12/14/2014","2014",1,4,5
"Florida","12/13/2014","2014",0,5,5
"Florida","11/15/2014","2014",1,3,4
"Florida","10/05/2014","2014",3,1,4
"Florida","09/28/2014","2014",0,15,15
"Florida","09/18/2014","2014",8,0,8
"Florida","09/06/2014","2014",0,4,4
"Florida","08/29/2014","2014",3,1,4
"Florida","07/06/2014","2014",2,2,4
"Florida","06/24/2014","2014",2,7,9
"Florida","06/08/2014","2014",5,0,5
"Florida","04/20/2014","2014",2,2,4
"Florida","02/16/2014","2014",1,6,7
"Florida","02/16/2014","2014",1,4,5
"Florida","02/07/2014","2014",0,5,5
"Florida","01/25/2014","2014",0,4,4
"Florida","09/04/2014","2014",4,0,4
"Florida","06/08/2014","2014",4,0,4
"Florida","12/25/2015","2015",0,4,4
"Florida","12/20/2015","2015",0,4,4
"Florida","12/19/2015","2015",1,4,5
"Florida","11/13/2015","2015",4,1,5
"Florida","11/03/2015","2015",2,3,5
"Florida","10/17/2015","2015",1,4,5
"Florida","09/23/2015","2015",0,4,4
"Florida","09/13/2015","2015",1,5,6
"Florida","09/05/2015","2015",0,4,4
"Florida","08/27/2015","2015",2,2,4
"Florida","08/26/2015","2015",2,2,4
"Florida","08/22/2015","2015",0,4,4
"Florida","08/01/2015","2015",0,4,4
"Florida","07/21/2015","2015",1,3,4
"Florida","06/29/2015","2015",0,4,4
"Florida","06/16/2015","2015",0,4,4
"Florida","06/12/2015","2015",0,4,4
"Florida","05/18/2015","2015",1,4,5
"Florida","04/03/2015","2015",0,4,4
"Florida","03/27/2015","2015",0,7,7
"Florida","03/21/2015","2015",0,4,4
"Florida","03/01/2015","2015",0,4,4
"Florida","02/23/2015","2015",0,4,4
"Florida","02/09/2015","2015",3,1,4
"Florida","01/11/2015","2015",1,3,4
"Florida","01/06/2015","2015",1,3,4
"Florida","06/12/2016","2016",49,53,102
"Florida","12/11/2016","2016",1,4,5
"Florida","11/22/2016","2016",1,4,5
"Florida","11/13/2016","2016",3,2,5
"Florida","11/13/2016","2016",0,4,4
"Florida","11/05/2016","2016",1,3,4
"Florida","10/28/2016","2016",0,4,4
"Florida","09/17/2016","2016",0,6,6
"Florida","09/17/2016","2016",1,6,7
"Florida","09/10/2016","2016",1,3,4
"Florida","08/27/2016","2016",2,4,6
"Florida","08/12/2016","2016",1,3,4
"Florida","08/08/2016","2016",0,7,7
"Florida","08/02/2016","2016",0,4,4
"Florida","07/31/2016","2016",3,1,4
"Florida","07/25/2016","2016",2,19,21
"Florida","06/09/2016","2016",0,4,4
"Florida","06/05/2016","2016",3,3,6
"Florida","05/05/2016","2016",1,3,4
"Florida","04/25/2016","2016",0,5,5
"Florida","04/16/2016","2016",2,4,6
"Florida","03/19/2016","2016",1,4,5
"Florida","03/13/2016","2016",0,4,4
"Florida","02/23/2016","2016",0,4,4
"Florida","02/20/2016","2016",1,3,4
"Florida","02/20/2016","2016",0,4,4
"Florida","02/07/2016","2016",2,10,12
"Florida","02/06/2016","2016",0,4,4
"Florida","02/06/2016","2016",2,6,8
"Florida","01/06/2016","2016",3,1,4
"Florida","06/05/2017","2017",5,0,5
"Florida","01/06/2017","2017",5,6,11
"Florida","12/26/2017","2017",0,5,5
"Florida","10/21/2017","2017",0,4,4
"Florida","10/21/2017","2017",0,4,4
"Florida","10/03/2017","2017",0,4,4
"Florida","08/25/2017","2017",0,4,4
"Florida","08/05/2017","2017",1,3,4
"Florida","07/25/2017","2017",1,3,4
"Florida","07/04/2017","2017",0,4,4
"Florida","06/24/2017","2017",1,4,5
"Florida","05/26/2017","2017",0,4,4
"Florida","05/14/2017","2017",0,5,5
"Florida","05/02/2017","2017",1,3,4
"Florida","04/30/2017","2017",0,5,5
"Florida","04/26/2017","2017",0,4,4
"Florida","04/21/2017","2017",2,2,4
"Florida","04/01/2017","2017",1,4,5
"Florida","03/27/2017","2017",2,4,6
"Florida","02/25/2017","2017",1,4,5
"Florida","02/12/2017","2017",0,5,5
"Florida","01/21/2017","2017",0,5,5
"Florida","01/16/2017","2017",0,8,8
"Florida","01/01/2017","2017",0,7,7
"Florida","02/14/2018","2018",17,17,34
"Florida","12/15/2018","2018",0,5,5
"Florida","12/01/2018","2018",0,5,5
"Florida","11/23/2018","2018",2,5,7
"Florida","11/02/2018","2018",3,4,7
"Florida","10/21/2018","2018",1,5,6
"Florida","09/29/2018","2018",1,4,5
"Florida","09/09/2018","2018",0,4,4
"Florida","09/01/2018","2018",1,3,4
"Florida","08/26/2018","2018",3,9,12
"Florida","07/16/2018","2018",2,4,6
"Florida","07/11/2018","2018",0,4,4
"Florida","07/09/2018","2018",1,4,5
"Florida","06/24/2018","2018",0,4,4
"Florida","06/24/2018","2018",0,4,4
"Florida","06/24/2018","2018",1,3,4
"Florida","06/11/2018","2018",6,0,6
"Florida","06/10/2018","2018",1,5,6
"Florida","06/05/2018","2018",3,1,4
"Florida","04/30/2018","2018",0,4,4
"Florida","04/29/2018","2018",1,3,4
"Florida","04/08/2018","2018",2,2,4
"Florida","04/06/2018","2018",0,4,4
"Florida","03/13/2018","2018",0,4,4
"Florida","03/03/2018","2018",0,4,4
"Florida","02/23/2018","2018",1,3,4
"Florida","02/14/2018","2018",17,17,34
"Florida","02/07/2018","2018",3,3,6
"Florida","01/21/2018","2018",0,4,4
"Florida","01/15/2018","2018",0,5,5
"Florida","01/07/2018","2018",0,4,4
"Florida","12/06/2019","2019",3,8,11
"Florida","01/23/2019","2019",5,0,5
"Florida","12/26/2019","2019",0,5,5
"Florida","11/25/2019","2019",2,2,4
"Florida","11/11/2019","2019",0,4,4
"Florida","10/10/2019","2019",2,2,4
"Florida","09/29/2019","2019",0,4,4
"Florida","09/04/2019","2019",0,4,4
"Florida","04/14/2019","2019",2,2,4
"Florida","04/06/2019","2019",0,4,4
"Florida","04/04/2019","2019",1,3,4
"Florida","01/20/2019","2019",0,4,4
"Florida","01/19/2019","2019",3,2,5
"Florida","01/16/2019","2019",1,5,6
"Florida","01/01/2019","2019",0,5,5
"Florida","12/26/2020","2020",2,2,4
"Florida","12/26/2020","2020",1,3,4
"Florida","12/25/2020","2020",1,4,5
"Florida","12/24/2020","2020",1,4,5
"Florida","11/19/2020","2020",1,3,4
"Florida","11/16/2020","2020",0,4,4
"Florida","11/12/2020","2020",2,4,6
"Florida","11/10/2020","2020",1,7,8
"Florida","10/29/2020","2020",0,4,4
"Florida","10/22/2020","2020",1,3,4
"Florida","10/16/2020","2020",3,1,4
"Florida","09/30/2020","2020",0,4,4
"Florida","09/13/2020","2020",0,4,4
"Florida","09/05/2020","2020",0,6,6
"Florida","09/03/2020","2020",1,3,4
"Florida","08/31/2020","2020",0,4,4
"Florida","08/24/2020","2020",0,4,4
"Florida","07/30/2020","2020",0,5,5
"Florida","07/30/2020","2020",0,5,5
"Florida","07/25/2020","2020",1,3,4
"Florida","07/17/2020","2020",0,4,4
"Florida","07/12/2020","2020",2,2,4
"Florida","06/23/2020","2020",0,5,5
"Florida","05/30/2020","2020",2,4,6
"Florida","05/23/2020","2020",0,5,5
"Florida","05/23/2020","2020",0,6,6
"Florida","05/15/2020","2020",0,5,5
"Florida","05/03/2020","2020",1,3,4
"Florida","04/25/2020","2020",1,4,5
"Florida","04/04/2020","2020",1,4,5
"Florida","03/18/2020","2020",1,4,5
"Florida","02/16/2020","2020",1,4,5
"Florida","01/31/2020","2020",1,3,4
"Florida","01/04/2020","2020",1,3,4
"Georgia","07/29/1999","1999",9,13,22
"Georgia","03/19/2006","2006",4,3,7
"Georgia","08/27/2009","2009",4,1,5
"Georgia","01/12/2010","2010",4,1,5
"Georgia","02/21/2012","2012",5,0,5
"Georgia","11/30/2013","2013",0,4,4
"Georgia","09/15/2013","2013",3,1,4
"Georgia","06/02/2013","2013",0,7,7
"Georgia","05/31/2013","2013",0,4,4
"Georgia","03/03/2013","2013",2,2,4
"Georgia","02/24/2013","2013",0,8,8
"Georgia","11/29/2014","2014",3,2,5
"Georgia","10/14/2014","2014",3,2,5
"Georgia","10/13/2014","2014",0,4,4
"Georgia","10/12/2014","2014",1,3,4
"Georgia","10/08/2014","2014",0,4,4
"Georgia","09/06/2014","2014",0,5,5
"Georgia","08/24/2014","2014",1,3,4
"Georgia","08/12/2014","2014",2,3,5
"Georgia","08/10/2014","2014",0,6,6
"Georgia","08/04/2014","2014",0,5,5
"Georgia","07/26/2014","2014",0,8,8
"Georgia","06/03/2014","2014",1,4,5
"Georgia","05/13/2014","2014",0,5,5
"Georgia","05/10/2014","2014",1,3,4
"Georgia","05/10/2014","2014",2,3,5
"Georgia","04/29/2014","2014",1,6,7
"Georgia","03/16/2014","2014",0,4,4
"Georgia","12/12/2015","2015",0,4,4
"Georgia","12/02/2015","2015",1,3,4
"Georgia","10/12/2015","2015",0,4,4
"Georgia","09/27/2015","2015",0,10,10
"Georgia","09/23/2015","2015",1,3,4
"Georgia","09/08/2015","2015",0,4,4
"Georgia","08/02/2015","2015",0,5,5
"Georgia","07/22/2015","2015",5,0,5
"Georgia","07/15/2015","2015",0,5,5
"Georgia","06/13/2015","2015",1,4,5
"Georgia","06/13/2015","2015",1,3,4
"Georgia","05/31/2015","2015",3,2,5
"Georgia","04/07/2015","2015",1,3,4
"Georgia","03/14/2015","2015",0,5,5
"Georgia","03/10/2015","2015",0,5,5
"Georgia","02/22/2015","2015",3,2,5
"Georgia","02/07/2015","2015",5,2,7
"Georgia","01/31/2015","2015",4,0,4
"Georgia","01/28/2015","2015",1,3,4
"Georgia","01/02/2015","2015",1,4,5
"Georgia","01/31/2015","2015",5,0,5
"Georgia","12/31/2016","2016",2,2,4
"Georgia","12/28/2016","2016",1,4,5
"Georgia","10/27/2016","2016",4,0,4
"Georgia","08/30/2016","2016",0,4,4
"Georgia","08/03/2016","2016",1,3,4
"Georgia","07/30/2016","2016",0,5,5
"Georgia","07/29/2016","2016",0,7,7
"Georgia","07/13/2016","2016",0,5,5
"Georgia","06/26/2016","2016",1,4,5
"Georgia","06/22/2016","2016",1,3,4
"Georgia","06/18/2016","2016",2,2,4
"Georgia","05/21/2016","2016",1,3,4
"Georgia","05/15/2016","2016",5,0,5
"Georgia","05/14/2016","2016",0,5,5
"Georgia","04/22/2016","2016",6,0,6
"Georgia","03/15/2016","2016",0,5,5
"Georgia","03/06/2016","2016",0,4,4
"Georgia","11/16/2017","2017",0,7,7
"Georgia","11/12/2017","2017",2,2,4
"Georgia","07/05/2017","2017",0,4,4
"Georgia","06/22/2017","2017",1,6,7
"Georgia","04/13/2017","2017",1,3,4
"Georgia","03/05/2017","2017",0,4,4
"Georgia","01/26/2017","2017",2,3,5
"Georgia","01/22/2017","2017",3,1,4
"Georgia","01/21/2017","2017",0,6,6
"Georgia","10/16/2018","2018",0,4,4
"Georgia","10/04/2018","2018",0,4,4
"Georgia","09/04/2018","2018",0,4,4
"Georgia","07/30/2018","2018",0,4,4
"Georgia","07/04/2018","2018",1,3,4
"Georgia","06/30/2018","2018",1,6,7
"Georgia","06/17/2018","2018",1,3,4
"Georgia","05/05/2018","2018",0,5,5
"Georgia","12/27/2019","2019",0,4,4
"Georgia","12/15/2019","2019",1,4,5
"Georgia","11/09/2019","2019",0,4,4
"Georgia","11/07/2019","2019",2,3,5
"Georgia","09/14/2019","2019",0,4,4
"Georgia","08/23/2019","2019",0,4,4
"Georgia","08/20/2019","2019",0,4,4
"Georgia","07/15/2019","2019",0,4,4
"Georgia","06/28/2019","2019",0,7,7
"Georgia","06/27/2019","2019",0,7,7
"Georgia","06/11/2019","2019",2,2,4
"Georgia","06/01/2019","2019",0,5,5
"Georgia","06/01/2019","2019",2,4,6
"Georgia","04/04/2019","2019",3,2,5
"Georgia","03/31/2019","2019",1,4,5
"Georgia","03/17/2019","2019",0,4,4
"Georgia","03/17/2019","2019",1,3,4
"Georgia","01/26/2019","2019",0,4,4
"Georgia","01/24/2019","2019",4,1,5
"Georgia","12/10/2020","2020",0,4,4
"Georgia","11/27/2020","2020",1,5,6
"Georgia","11/15/2020","2020",2,2,4
"Georgia","10/11/2020","2020",0,4,4
"Georgia","10/04/2020","2020",1,5,6
"Georgia","09/23/2020","2020",1,3,4
"Georgia","09/06/2020","2020",1,6,7
"Georgia","09/02/2020","2020",1,3,4
"Georgia","07/24/2020","2020",2,2,4
"Georgia","07/05/2020","2020",2,13,15
"Georgia","07/04/2020","2020",0,5,5
"Georgia","06/30/2020","2020",1,4,5
"Georgia","06/13/2020","2020",2,5,7
"Georgia","05/06/2020","2020",1,3,4
"Georgia","03/31/2020","2020",3,1,4
"Georgia","03/29/2020","2020",0,4,4
"Georgia","01/05/2020","2020",0,4,4
"Hawaii","11/02/1999","1999",7,0,7
"Idaho","05/11/2011","2011",4,0,4
"Idaho","02/20/2020","2020",2,3,5
"Illinois","02/05/2001","2001",5,4,9
"Illinois","06/14/2007","2007",4,0,4
"Illinois","02/14/2008","2008",5,21,26
"Illinois","04/23/2008","2008",5,0,5
"Illinois","02/14/2008","2008",5,21,26
"Illinois","02/02/2008","2008",5,1,6
"Illinois","09/02/2010","2010",4,0,4
"Illinois","04/14/2010","2010",5,2,7
"Illinois","12/16/2011","2011",4,0,4
"Illinois","01/17/2012","2012",4,0,4
"Illinois","09/29/2013","2013",0,4,4
"Illinois","09/19/2013","2013",0,13,13
"Illinois","08/19/2013","2013",1,4,5
"Illinois","08/18/2013","2013",1,3,4
"Illinois","07/09/2013","2013",2,2,4
"Illinois","07/07/2013","2013",0,5,5
"Illinois","07/04/2013","2013",0,4,4
"Illinois","06/28/2013","2013",0,6,6
"Illinois","06/25/2013","2013",1,3,4
"Illinois","06/21/2013","2013",1,3,4
"Illinois","06/16/2013","2013",1,3,4
"Illinois","06/10/2013","2013",1,4,5
"Illinois","05/29/2013","2013",0,4,4
"Illinois","05/20/2013","2013",0,4,4
"Illinois","04/24/2013","2013",6,1,7
"Illinois","04/22/2013","2013",0,4,4
"Illinois","03/21/2013","2013",0,7,7
"Illinois","02/07/2013","2013",0,4,4
"Illinois","12/26/2014","2014",1,3,4
"Illinois","12/22/2014","2014",0,5,5
"Illinois","12/21/2014","2014",1,8,9
"Illinois","12/20/2014","2014",4,0,4
"Illinois","11/19/2014","2014",1,3,4
"Illinois","08/24/2014","2014",1,3,4
"Illinois","07/25/2014","2014",1,6,7
"Illinois","07/20/2014","2014",1,3,4
"Illinois","07/19/2014","2014",0,4,4
"Illinois","07/11/2014","2014",1,3,4
"Illinois","07/05/2014","2014",0,5,5
"Illinois","06/15/2014","2014",0,4,4
"Illinois","06/04/2014","2014",1,3,4
"Illinois","06/02/2014","2014",0,7,7
"Illinois","06/01/2014","2014",1,5,6
"Illinois","05/12/2014","2014",0,4,4
"Illinois","05/04/2014","2014",1,3,4
"Illinois","04/30/2014","2014",0,4,4
"Illinois","04/20/2014","2014",0,6,6
"Illinois","04/20/2014","2014",0,5,5
"Illinois","04/09/2014","2014",0,5,5
"Illinois","04/05/2014","2014",1,5,6
"Illinois","03/08/2014","2014",0,6,6
"Illinois","02/05/2014","2014",1,3,4
"Illinois","01/25/2014","2014",1,4,5
"Illinois","01/12/2014","2014",0,5,5
"Illinois","12/12/2015","2015",1,3,4
"Illinois","11/29/2015","2015",0,5,5
"Illinois","11/22/2015","2015",0,4,4
"Illinois","10/19/2015","2015",0,6,6
"Illinois","10/10/2015","2015",1,3,4
"Illinois","09/28/2015","2015",3,2,5
"Illinois","09/27/2015","2015",0,4,4
"Illinois","09/25/2015","2015",0,4,4
"Illinois","09/24/2015","2015",0,5,5
"Illinois","09/20/2015","2015",1,5,6
"Illinois","09/08/2015","2015",0,4,4
"Illinois","08/26/2015","2015",2,2,4
"Illinois","08/16/2015","2015",0,4,4
"Illinois","08/02/2015","2015",1,4,5
"Illinois","07/27/2015","2015",0,5,5
"Illinois","07/17/2015","2015",0,5,5
"Illinois","07/12/2015","2015",2,3,5
"Illinois","06/28/2015","2015",0,6,6
"Illinois","06/06/2015","2015",0,5,5
"Illinois","05/28/2015","2015",0,5,5
"Illinois","05/25/2015","2015",1,4,5
"Illinois","03/09/2015","2015",1,3,4
"Illinois","01/13/2015","2015",2,2,4
"Illinois","12/25/2016","2016",3,4,7
"Illinois","12/23/2016","2016",0,4,4
"Illinois","12/17/2016","2016",5,0,5
"Illinois","12/16/2016","2016",0,4,4
"Illinois","11/26/2016","2016",1,5,6
"Illinois","11/18/2016","2016",0,4,4
"Illinois","11/09/2016","2016",1,3,4
"Illinois","11/05/2016","2016",0,5,5
"Illinois","11/03/2016","2016",2,2,4
"Illinois","10/17/2016","2016",1,4,5
"Illinois","10/15/2016","2016",1,5,6
"Illinois","10/14/2016","2016",1,6,7
"Illinois","10/13/2016","2016",0,4,4
"Illinois","10/01/2016","2016",4,0,4
"Illinois","09/25/2016","2016",1,3,4
"Illinois","09/05/2016","2016",2,3,5
"Illinois","09/03/2016","2016",0,4,4
"Illinois","08/30/2016","2016",0,4,4
"Illinois","08/10/2016","2016",0,4,4
"Illinois","08/07/2016","2016",0,4,4
"Illinois","07/28/2016","2016",2,2,4
"Illinois","07/22/2016","2016",0,5,5
"Illinois","07/21/2016","2016",0,5,5
"Illinois","07/04/2016","2016",0,4,4
"Illinois","06/30/2016","2016",1,4,5
"Illinois","06/28/2016","2016",0,4,4
"Illinois","06/25/2016","2016",0,4,4
"Illinois","06/22/2016","2016",0,4,4
"Illinois","06/18/2016","2016",0,4,4
"Illinois","06/13/2016","2016",0,5,5
"Illinois","05/31/2016","2016",0,4,4
"Illinois","05/11/2016","2016",0,5,5
"Illinois","04/24/2016","2016",2,3,5
"Illinois","04/19/2016","2016",1,3,4
"Illinois","04/07/2016","2016",0,4,4
"Illinois","03/31/2016","2016",0,4,4
"Illinois","03/25/2016","2016",0,4,4
"Illinois","03/21/2016","2016",0,4,4
"Illinois","02/07/2016","2016",0,4,4
"Illinois","01/08/2016","2016",1,4,5
"Illinois","12/17/2016","2016",5,1,6
"Illinois","02/04/2016","2016",6,0,6
"Illinois","12/31/2017","2017",0,4,4
"Illinois","12/06/2017","2017",0,4,4
"Illinois","10/06/2017","2017",0,5,5
"Illinois","09/23/2017","2017",0,5,5
"Illinois","09/15/2017","2017",4,0,4
"Illinois","09/06/2017","2017",0,4,4
"Illinois","09/04/2017","2017",0,4,4
"Illinois","09/02/2017","2017",1,3,4
"Illinois","08/22/2017","2017",0,4,4
"Illinois","08/20/2017","2017",2,5,7
"Illinois","08/08/2017","2017",1,6,7
"Illinois","08/01/2017","2017",0,4,4
"Illinois","07/31/2017","2017",0,4,4
"Illinois","07/27/2017","2017",1,4,5
"Illinois","07/23/2017","2017",1,3,4
"Illinois","07/15/2017","2017",0,4,4
"Illinois","07/08/2017","2017",0,4,4
"Illinois","07/05/2017","2017",2,2,4
"Illinois","07/01/2017","2017",0,4,4
"Illinois","06/27/2017","2017",0,5,5
"Illinois","06/18/2017","2017",0,4,4
"Illinois","06/17/2017","2017",0,4,4
"Illinois","06/11/2017","2017",0,9,9
"Illinois","05/14/2017","2017",0,5,5
"Illinois","05/07/2017","2017",2,8,10
"Illinois","04/15/2017","2017",0,4,4
"Illinois","04/15/2017","2017",0,4,4
"Illinois","04/07/2017","2017",1,5,6
"Illinois","04/02/2017","2017",2,4,6
"Illinois","03/30/2017","2017",4,0,4
"Illinois","03/10/2017","2017",2,2,4
"Illinois","03/07/2017","2017",0,4,4
"Illinois","02/15/2017","2017",3,2,5
"Illinois","02/11/2017","2017",1,3,4
"Illinois","01/25/2017","2017",0,6,6
"Illinois","01/22/2017","2017",0,4,4
"Illinois","01/11/2017","2017",1,3,4
"Illinois","10/24/2018","2018",0,5,5
"Illinois","10/22/2018","2018",0,6,6
"Illinois","10/01/2018","2018",2,2,4
"Illinois","09/19/2018","2018",0,4,4
"Illinois","09/11/2018","2018",0,4,4
"Illinois","09/09/2018","2018",1,3,4
"Illinois","08/19/2018","2018",0,5,5
"Illinois","08/17/2018","2018",0,7,7
"Illinois","08/05/2018","2018",1,4,5
"Illinois","08/04/2018","2018",1,3,4
"Illinois","07/30/2018","2018",0,4,4
"Illinois","07/27/2018","2018",0,4,4
"Illinois","07/23/2018","2018",0,5,5
"Illinois","07/21/2018","2018",2,5,7
"Illinois","07/01/2018","2018",0,6,6
"Illinois","06/25/2018","2018",0,6,6
"Illinois","06/23/2018","2018",1,4,5
"Illinois","06/21/2018","2018",0,4,4
"Illinois","06/18/2018","2018",3,1,4
"Illinois","06/18/2018","2018",2,3,5
"Illinois","06/17/2018","2018",0,4,4
"Illinois","06/10/2018","2018",0,7,7
"Illinois","06/10/2018","2018",1,5,6
"Illinois","06/10/2018","2018",2,2,4
"Illinois","06/03/2018","2018",1,3,4
"Illinois","05/04/2018","2018",0,4,4
"Illinois","05/02/2018","2018",1,4,5
"Illinois","03/17/2018","2018",0,4,4
"Illinois","03/11/2018","2018",1,3,4
"Illinois","03/04/2018","2018",1,4,5
"Illinois","01/21/2018","2018",0,4,4
"Illinois","02/15/2019","2019",5,6,11
"Illinois","12/29/2019","2019",0,5,5
"Illinois","12/24/2019","2019",0,5,5
"Illinois","12/22/2019","2019",0,13,13
"Illinois","12/01/2019","2019",1,4,5
"Illinois","10/12/2019","2019",5,0,5
"Illinois","09/29/2019","2019",1,3,4
"Illinois","09/24/2019","2019",1,3,4
"Illinois","09/18/2019","2019",3,1,4
"Illinois","09/10/2019","2019",0,4,4
"Illinois","09/02/2019","2019",0,4,4
"Illinois","08/31/2019","2019",2,3,5
"Illinois","08/25/2019","2019",1,3,4
"Illinois","08/11/2019","2019",0,6,6
"Illinois","08/09/2019","2019",0,4,4
"Illinois","08/04/2019","2019",1,7,8
"Illinois","07/28/2019","2019",0,4,4
"Illinois","07/21/2019","2019",0,4,4
"Illinois","07/20/2019","2019",0,7,7
"Illinois","07/18/2019","2019",1,3,4
"Illinois","07/14/2019","2019",0,4,4
"Illinois","07/13/2019","2019",1,4,5
"Illinois","07/07/2019","2019",0,4,4
"Illinois","07/05/2019","2019",0,5,5
"Illinois","07/04/2019","2019",0,4,4
"Illinois","07/04/2019","2019",1,3,4
"Illinois","06/29/2019","2019",0,5,5
"Illinois","06/21/2019","2019",0,4,4
"Illinois","06/08/2019","2019",0,4,4
"Illinois","06/06/2019","2019",1,3,4
"Illinois","06/01/2019","2019",0,4,4
"Illinois","05/30/2019","2019",0,5,5
"Illinois","04/12/2019","2019",0,4,4
"Illinois","04/06/2019","2019",0,6,6
"Illinois","03/31/2019","2019",1,4,5
"Illinois","03/03/2019","2019",0,6,6
"Illinois","02/03/2019","2019",2,5,7
"Illinois","01/19/2019","2019",0,4,4
"Illinois","12/26/2020","2020",3,3,6
"Illinois","12/19/2020","2020",0,6,6
"Illinois","12/04/2020","2020",0,4,4
"Illinois","11/22/2020","2020",1,3,4
"Illinois","11/21/2020","2020",0,6,6
"Illinois","11/16/2020","2020",0,4,4
"Illinois","10/30/2020","2020",1,3,4
"Illinois","10/18/2020","2020",1,4,5
"Illinois","10/10/2020","2020",1,3,4
"Illinois","09/26/2020","2020",0,4,4
"Illinois","09/19/2020","2020",0,4,4
"Illinois","09/15/2020","2020",0,5,5
"Illinois","09/13/2020","2020",1,3,4
"Illinois","09/12/2020","2020",2,4,6
"Illinois","09/06/2020","2020",0,4,4
"Illinois","08/30/2020","2020",1,3,4
"Illinois","08/30/2020","2020",1,4,5
"Illinois","08/29/2020","2020",1,5,6
"Illinois","08/23/2020","2020",0,4,4
"Illinois","08/23/2020","2020",0,4,4
"Illinois","08/22/2020","2020",1,3,4
"Illinois","08/19/2020","2020",0,6,6
"Illinois","08/18/2020","2020",0,4,4
"Illinois","08/05/2020","2020",0,4,4
"Illinois","08/01/2020","2020",1,4,5
"Illinois","07/27/2020","2020",1,4,5
"Illinois","07/23/2020","2020",2,4,6
"Illinois","07/21/2020","2020",0,15,15
"Illinois","07/20/2020","2020",0,5,5
"Illinois","07/19/2020","2020",2,3,5
"Illinois","07/19/2020","2020",0,13,13
"Illinois","07/18/2020","2020",1,4,5
"Illinois","07/12/2020","2020",1,3,4
"Illinois","07/06/2020","2020",0,6,6
"Illinois","07/05/2020","2020",0,4,4
"Illinois","07/05/2020","2020",1,5,6
"Illinois","07/04/2020","2020",1,3,4
"Illinois","06/30/2020","2020",0,4,4
"Illinois","06/27/2020","2020",2,2,4
"Illinois","06/27/2020","2020",0,4,4
"Illinois","06/23/2020","2020",0,4,4
"Illinois","06/22/2020","2020",0,5,5
"Illinois","06/21/2020","2020",1,3,4
"Illinois","06/17/2020","2020",0,4,4
"Illinois","06/15/2020","2020",0,4,4
"Illinois","06/07/2020","2020",1,3,4
"Illinois","06/07/2020","2020",1,3,4
"Illinois","06/02/2020","2020",0,4,4
"Illinois","05/26/2020","2020",2,2,4
"Illinois","05/23/2020","2020",1,4,5
"Illinois","05/23/2020","2020",1,3,4
"Illinois","05/19/2020","2020",0,5,5
"Illinois","05/13/2020","2020",1,4,5
"Illinois","05/03/2020","2020",0,5,5
"Illinois","04/07/2020","2020",1,3,4
"Illinois","03/13/2020","2020",0,4,4
"Illinois","03/08/2020","2020",0,4,4
"Illinois","03/07/2020","2020",0,7,7
"Illinois","02/25/2020","2020",1,4,5
"Illinois","02/14/2020","2020",0,6,6
"Illinois","01/16/2020","2020",0,5,5
"Indiana","06/01/2006","2006",7,0,7
"Indiana","01/14/2008","2008",4,0,4
"Indiana","09/25/2011","2011",5,0,5
"Indiana","11/29/2013","2013",0,4,4
"Indiana","09/07/2013","2013",2,4,6
"Indiana","08/02/2013","2013",0,4,4
"Indiana","06/02/2013","2013",0,4,4
"Indiana","05/11/2013","2013",5,0,5
"Indiana","03/05/2013","2013",1,3,4
"Indiana","05/11/2013","2013",4,0,4
"Indiana","12/07/2014","2014",0,4,4
"Indiana","07/05/2014","2014",0,7,7
"Indiana","06/15/2014","2014",0,4,4
"Indiana","04/11/2014","2014",0,4,4
"Indiana","02/20/2014","2014",4,0,4
"Indiana","02/16/2014","2014",0,5,5
"Indiana","02/12/2014","2014",0,5,5
"Indiana","02/03/2014","2014",3,2,5
"Indiana","11/09/2015","2015",2,2,4
"Indiana","10/26/2015","2015",0,5,5
"Indiana","10/17/2015","2015",0,4,4
"Indiana","09/19/2015","2015",1,3,4
"Indiana","09/07/2015","2015",2,4,6
"Indiana","07/05/2015","2015",0,9,9
"Indiana","07/02/2015","2015",1,3,4
"Indiana","05/03/2015","2015",0,4,4
"Indiana","04/05/2015","2015",0,5,5
"Indiana","03/24/2015","2015",4,0,4
"Indiana","09/17/2016","2016",2,2,4
"Indiana","09/13/2016","2016",3,2,5
"Indiana","09/11/2016","2016",3,1,4
"Indiana","08/01/2016","2016",0,4,4
"Indiana","05/31/2016","2016",0,4,4
"Indiana","05/29/2016","2016",0,4,4
"Indiana","05/18/2016","2016",0,4,4
"Indiana","05/15/2016","2016",0,4,4
"Indiana","11/12/2017","2017",0,7,7
"Indiana","09/20/2017","2017",0,5,5
"Indiana","08/27/2017","2017",1,3,4
"Indiana","04/15/2017","2017",0,4,4
"Indiana","04/09/2017","2017",1,3,4
"Indiana","02/26/2017","2017",1,4,5
"Indiana","02/18/2017","2017",1,3,4
"Indiana","11/22/2018","2018",3,2,5
"Indiana","06/24/2018","2018",1,3,4
"Indiana","06/10/2018","2018",1,4,5
"Indiana","05/20/2018","2018",0,4,4
"Indiana","03/11/2018","2018",0,6,6
"Indiana","01/28/2018","2018",2,3,5
"Indiana","10/06/2019","2019",0,5,5
"Indiana","09/23/2019","2019",2,2,4
"Indiana","09/21/2019","2019",0,6,6
"Indiana","06/23/2019","2019",1,10,11
"Indiana","05/18/2019","2019",1,6,7
"Indiana","05/08/2019","2019",0,4,4
"Indiana","05/04/2019","2019",0,4,4
"Indiana","04/07/2019","2019",2,2,4
"Indiana","02/17/2019","2019",0,5,5
"Indiana","01/26/2019","2019",0,5,5
"Indiana","12/31/2020","2020",1,3,4
"Indiana","11/01/2020","2020",0,4,4
"Indiana","10/04/2020","2020",3,4,7
"Indiana","09/07/2020","2020",1,4,5
"Indiana","04/29/2020","2020",0,4,4
"Indiana","04/24/2020","2020",0,4,4
"Indiana","02/05/2020","2020",4,0,4
"Iowa","11/01/1991","1991",6,1,7
"Iowa","10/14/2006","2006",5,0,5
"Iowa","11/08/2015","2015",1,3,4
"Iowa","06/05/2015","2015",0,5,5
"Iowa","05/21/2017","2017",1,3,4
"Iowa","04/02/2017","2017",0,5,5
"Iowa","12/25/2019","2019",1,3,4
"Iowa","06/16/2019","2019",0,6,6
"Iowa","05/18/2019","2019",2,2,4
"Iowa","09/26/2020","2020",2,6,8
"Iowa","07/05/2020","2020",1,3,4
"Iowa","06/30/2020","2020",0,5,5
"Iowa","06/16/2020","2020",2,2,4
"Kansas","12/16/2006","2006",6,0,6
"Kansas","10/14/2006","2006",4,0,4
"Kansas","11/28/2009","2009",4,0,4
"Kansas","06/22/2009","2009",4,0,4
"Kansas","12/01/2013","2013",4,0,4
"Kansas","09/22/2013","2013",1,6,7
"Kansas","07/24/2013","2013",0,4,4
"Kansas","07/14/2013","2013",1,4,5
"Kansas","01/10/2015","2015",2,2,4
"Kansas","02/25/2016","2016",3,14,17
"Kansas","06/24/2016","2016",0,4,4
"Kansas","04/23/2016","2016",1,4,5
"Kansas","03/07/2016","2016",5,0,5
"Kansas","03/05/2016","2016",0,4,4
"Kansas","10/01/2017","2017",3,2,5
"Kansas","05/09/2017","2017",3,1,4
"Kansas","04/30/2017","2017",4,1,5
"Kansas","03/04/2017","2017",1,4,5
"Kansas","06/23/2018","2018",0,4,4
"Kansas","02/17/2018","2018",1,7,8
"Kansas","10/06/2019","2019",4,5,9
"Kansas","09/29/2019","2019",0,4,4
"Kansas","07/27/2019","2019",1,3,4
"Kansas","04/19/2019","2019",0,4,4
"Kansas","11/07/2020","2020",0,4,4
"Kansas","06/20/2020","2020",0,5,5
"Kentucky","06/25/2008","2008",6,1,7
"Kentucky","09/11/2010","2010",5,0,5
"Kentucky","11/02/2013","2013",1,3,4
"Kentucky","07/12/2013","2013",2,2,4
"Kentucky","04/14/2013","2013",1,4,5
"Kentucky","12/23/2014","2014",1,3,4
"Kentucky","10/26/2014","2014",4,0,4
"Kentucky","07/07/2014","2014",0,4,4
"Kentucky","06/30/2014","2014",1,3,4
"Kentucky","07/19/2015","2015",0,6,6
"Kentucky","07/04/2015","2015",0,4,4
"Kentucky","06/21/2015","2015",1,4,5
"Kentucky","04/05/2015","2015",1,4,5
"Kentucky","11/17/2015","2015",4,0,4
"Kentucky","11/24/2016","2016",2,4,6
"Kentucky","06/21/2016","2016",2,2,4
"Kentucky","12/12/2017","2017",0,4,4
"Kentucky","10/27/2017","2017",0,6,6
"Kentucky","09/02/2017","2017",0,4,4
"Kentucky","05/29/2017","2017",1,3,4
"Kentucky","04/20/2017","2017",0,4,4
"Kentucky","03/19/2017","2017",1,5,6
"Kentucky","03/17/2018","2018",0,7,7
"Kentucky","02/10/2018","2018",5,0,5
"Kentucky","01/27/2018","2018",0,4,4
"Kentucky","01/23/2018","2018",2,14,16
"Kentucky","06/16/2019","2019",1,6,7
"Kentucky","04/18/2019","2019",0,4,4
"Kentucky","04/02/2019","2019",0,5,5
"Kentucky","02/21/2019","2019",2,2,4
"Kentucky","01/17/2019","2019",3,1,4
"Kentucky","08/30/2020","2020",0,7,7
"Kentucky","08/30/2020","2020",0,5,5
"Kentucky","08/16/2020","2020",1,3,4
"Kentucky","08/08/2020","2020",1,4,5
"Kentucky","07/26/2020","2020",1,3,4
"Kentucky","07/13/2020","2020",1,3,4
"Kentucky","06/14/2020","2020",1,4,5
"Kentucky","05/28/2020","2020",0,7,7
"Kentucky","05/13/2020","2020",1,4,5
"Kentucky","04/03/2020","2020",0,4,4
"Louisiana","11/04/2006","2006",4,0,4
"Louisiana","07/24/2006","2006",4,0,4
"Louisiana","06/27/2006","2006",4,0,4
"Louisiana","06/17/2006","2006",5,0,5
"Louisiana","05/21/2006","2006",5,1,6
"Louisiana","10/30/2008","2008",4,0,4
"Louisiana","09/04/2010","2010",4,0,4
"Louisiana","03/25/2010","2010",4,0,4
"Louisiana","12/26/2013","2013",2,6,8
"Louisiana","12/26/2013","2013",3,3,6
"Louisiana","06/23/2013","2013",0,4,4
"Louisiana","05/12/2013","2013",0,19,19
"Louisiana","04/22/2013","2013",0,5,5
"Louisiana","03/02/2013","2013",1,3,4
"Louisiana","02/09/2013","2013",0,4,4
"Louisiana","01/26/2013","2013",2,3,5
"Louisiana","01/21/2013","2013",0,5,5
"Louisiana","12/29/2014","2014",0,4,4
"Louisiana","09/15/2014","2014",0,5,5
"Louisiana","08/18/2014","2014",0,4,4
"Louisiana","08/13/2014","2014",0,4,4
"Louisiana","08/10/2014","2014",2,5,7
"Louisiana","06/29/2014","2014",1,9,10
"Louisiana","05/23/2014","2014",1,7,8
"Louisiana","04/12/2014","2014",1,3,4
"Louisiana","04/07/2014","2014",0,4,4
"Louisiana","02/06/2014","2014",0,4,4
"Louisiana","01/12/2014","2014",0,6,6
"Louisiana","12/31/2015","2015",0,6,6
"Louisiana","12/06/2015","2015",1,3,4
"Louisiana","11/22/2015","2015",0,17,17
"Louisiana","10/28/2015","2015",1,3,4
"Louisiana","10/18/2015","2015",0,4,4
"Louisiana","09/23/2015","2015",0,5,5
"Louisiana","09/12/2015","2015",0,4,4
"Louisiana","08/25/2015","2015",1,3,4
"Louisiana","07/26/2015","2015",0,4,4
"Louisiana","07/23/2015","2015",3,9,12
"Louisiana","07/18/2015","2015",2,2,4
"Louisiana","07/05/2015","2015",0,6,6
"Louisiana","06/25/2015","2015",0,4,4
"Louisiana","06/05/2015","2015",1,3,4
"Louisiana","05/26/2015","2015",2,2,4
"Louisiana","11/27/2016","2016",1,9,10
"Louisiana","11/25/2016","2016",0,4,4
"Louisiana","10/31/2016","2016",0,4,4
"Louisiana","10/04/2016","2016",3,2,5
"Louisiana","09/11/2016","2016",1,5,6
"Louisiana","07/17/2016","2016",5,2,7
"Louisiana","07/07/2016","2016",0,4,4
"Louisiana","07/03/2016","2016",2,3,5
"Louisiana","05/22/2016","2016",0,4,4
"Louisiana","05/05/2016","2016",2,6,8
"Louisiana","04/27/2016","2016",2,2,4
"Louisiana","03/27/2016","2016",0,4,4
"Louisiana","03/07/2016","2016",0,4,4
"Louisiana","02/13/2016","2016",0,4,4
"Louisiana","12/23/2017","2017",1,3,4
"Louisiana","12/21/2017","2017",0,4,4
"Louisiana","11/17/2017","2017",0,4,4
"Louisiana","11/11/2017","2017",1,5,6
"Louisiana","11/03/2017","2017",1,4,5
"Louisiana","09/28/2017","2017",1,3,4
"Louisiana","09/10/2017","2017",1,3,4
"Louisiana","07/23/2017","2017",0,4,4
"Louisiana","06/08/2017","2017",0,6,6
"Louisiana","06/03/2017","2017",3,2,5
"Louisiana","04/06/2017","2017",1,3,4
"Louisiana","03/15/2017","2017",3,1,4
"Louisiana","03/10/2017","2017",3,1,4
"Louisiana","02/10/2017","2017",1,5,6
"Louisiana","01/29/2017","2017",1,4,5
"Louisiana","12/24/2018","2018",2,2,4
"Louisiana","12/11/2018","2018",1,3,4
"Louisiana","11/14/2018","2018",3,1,4
"Louisiana","09/18/2018","2018",0,4,4
"Louisiana","07/28/2018","2018",3,7,10
"Louisiana","07/25/2018","2018",0,4,4
"Louisiana","06/21/2018","2018",0,4,4
"Louisiana","05/27/2018","2018",0,4,4
"Louisiana","05/01/2018","2018",0,5,5
"Louisiana","04/22/2018","2018",2,4,6
"Louisiana","04/15/2018","2018",0,6,6
"Louisiana","04/04/2018","2018",2,2,4
"Louisiana","02/13/2018","2018",2,3,5
"Louisiana","12/24/2019","2019",0,4,4
"Louisiana","12/21/2019","2019",0,4,4
"Louisiana","12/08/2019","2019",1,4,5
"Louisiana","12/01/2019","2019",2,3,5
"Louisiana","12/01/2019","2019",2,2,4
"Louisiana","11/24/2019","2019",2,2,4
"Louisiana","11/23/2019","2019",1,6,7
"Louisiana","11/02/2019","2019",0,4,4
"Louisiana","09/21/2019","2019",0,4,4
"Louisiana","09/20/2019","2019",1,5,6
"Louisiana","09/08/2019","2019",1,3,4
"Louisiana","09/04/2019","2019",2,2,4
"Louisiana","08/04/2019","2019",0,4,4
"Louisiana","06/29/2019","2019",0,4,4
"Louisiana","06/29/2019","2019",0,7,7
"Louisiana","06/15/2019","2019",0,4,4
"Louisiana","05/29/2019","2019",1,3,4
"Louisiana","05/20/2019","2019",1,4,5
"Louisiana","05/15/2019","2019",0,4,4
"Louisiana","05/13/2019","2019",0,4,4
"Louisiana","04/07/2019","2019",0,4,4
"Louisiana","03/10/2019","2019",0,4,4
"Louisiana","02/17/2019","2019",1,5,6
"Louisiana","02/04/2019","2019",0,4,4
"Louisiana","01/26/2019","2019",5,0,5
"Louisiana","12/08/2020","2020",2,3,5
"Louisiana","11/28/2020","2020",0,4,4
"Louisiana","11/22/2020","2020",1,3,4
"Louisiana","11/15/2020","2020",0,5,5
"Louisiana","11/06/2020","2020",2,2,4
"Louisiana","10/22/2020","2020",0,5,5
"Louisiana","10/19/2020","2020",1,3,4
"Louisiana","10/15/2020","2020",2,2,4
"Louisiana","09/14/2020","2020",0,4,4
"Louisiana","09/11/2020","2020",0,5,5
"Louisiana","09/10/2020","2020",3,2,5
"Louisiana","09/07/2020","2020",0,4,4
"Louisiana","09/06/2020","2020",0,5,5
"Louisiana","07/15/2020","2020",1,3,4
"Louisiana","07/12/2020","2020",1,7,8
"Louisiana","07/04/2020","2020",0,4,4
"Louisiana","07/01/2020","2020",0,4,4
"Louisiana","06/14/2020","2020",0,5,5
"Louisiana","06/14/2020","2020",0,4,4
"Louisiana","06/14/2020","2020",2,2,4
"Louisiana","06/11/2020","2020",6,0,6
"Louisiana","05/25/2020","2020",0,6,6
"Louisiana","05/16/2020","2020",0,13,13
"Louisiana","05/10/2020","2020",0,5,5
"Louisiana","03/13/2020","2020",0,5,5
"Louisiana","02/15/2020","2020",0,4,4
"Louisiana","01/31/2020","2020",0,4,4
"Lousiana","07/17/2016","2016",3,3,6
"Maine","07/26/2014","2014",5,0,5
"Maine","07/05/2017","2017",4,1,5
"Maine","02/03/2020","2020",3,1,4
"Maryland","11/22/2007","2007",4,0,4
"Maryland","02/02/2008","2008",4,0,4
"Maryland","04/17/2009","2009",4,0,4
"Maryland","08/06/2010","2010",4,0,4
"Maryland","08/20/2013","2013",2,2,4
"Maryland","07/09/2013","2013",0,4,4
"Maryland","06/22/2013","2013",1,4,5
"Maryland","01/23/2013","2013",1,6,7
"Maryland","06/20/2014","2014",0,4,4
"Maryland","12/11/2015","2015",1,3,4
"Maryland","11/21/2015","2015",1,3,4
"Maryland","10/06/2015","2015",0,5,5
"Maryland","10/02/2015","2015",1,4,5
"Maryland","08/02/2015","2015",0,7,7
"Maryland","07/15/2015","2015",1,3,4
"Maryland","07/07/2015","2015",3,1,4
"Maryland","05/31/2015","2015",1,3,4
"Maryland","05/20/2015","2015",1,3,4
"Maryland","05/16/2015","2015",0,5,5
"Maryland","05/12/2015","2015",1,4,5
"Maryland","04/02/2015","2015",0,5,5
"Maryland","02/28/2015","2015",1,3,4
"Maryland","12/11/2016","2016",0,5,5
"Maryland","11/30/2016","2016",2,4,6
"Maryland","10/30/2016","2016",3,3,6
"Maryland","09/24/2016","2016",0,8,8
"Maryland","07/28/2016","2016",0,4,4
"Maryland","07/11/2016","2016",0,5,5
"Maryland","06/24/2016","2016",3,2,5
"Maryland","05/30/2016","2016",0,5,5
"Maryland","05/06/2016","2016",3,3,6
"Maryland","04/26/2016","2016",1,4,5
"Maryland","04/21/2016","2016",0,4,4
"Maryland","10/18/2017","2017",3,3,6
"Maryland","09/26/2017","2017",2,2,4
"Maryland","09/24/2017","2017",0,4,4
"Maryland","08/21/2017","2017",1,3,4
"Maryland","08/02/2017","2017",0,4,4
"Maryland","06/13/2017","2017",0,4,4
"Maryland","04/29/2017","2017",1,3,4
"Maryland","09/20/2018","2018",3,3,6
"Maryland","06/28/2018","2018",5,2,7
"Maryland","12/18/2018","2018",0,5,5
"Maryland","09/20/2018","2018",4,3,7
"Maryland","09/17/2018","2018",4,1,5
"Maryland","08/23/2018","2018",0,4,4
"Maryland","07/21/2018","2018",0,4,4
"Maryland","07/14/2018","2018",0,4,4
"Maryland","06/30/2018","2018",0,6,6
"Maryland","05/14/2018","2018",0,4,4
"Maryland","12/22/2019","2019",0,7,7
"Maryland","10/29/2019","2019",1,3,4
"Maryland","10/28/2019","2019",1,3,4
"Maryland","10/12/2019","2019",1,3,4
"Maryland","10/09/2019","2019",1,3,4
"Maryland","08/31/2019","2019",0,4,4
"Maryland","08/31/2019","2019",0,4,4
"Maryland","08/30/2019","2019",1,3,4
"Maryland","08/29/2019","2019",1,3,4
"Maryland","08/24/2019","2019",0,7,7
"Maryland","07/20/2019","2019",1,3,4
"Maryland","07/01/2019","2019",0,4,4
"Maryland","06/22/2019","2019",1,4,5
"Maryland","05/25/2019","2019",0,4,4
"Maryland","05/03/2019","2019",0,5,5
"Maryland","04/28/2019","2019",1,7,8
"Maryland","04/16/2019","2019",1,3,4
"Maryland","04/11/2019","2019",1,3,4
"Maryland","03/28/2019","2019",0,4,4
"Maryland","02/21/2019","2019",1,4,5
"Maryland","12/12/2020","2020",2,2,4
"Maryland","10/31/2020","2020",0,7,7
"Maryland","10/30/2020","2020",1,3,4
"Maryland","10/22/2020","2020",0,4,4
"Maryland","10/18/2020","2020",1,3,4
"Maryland","10/15/2020","2020",0,7,7
"Maryland","09/08/2020","2020",0,5,5
"Maryland","09/06/2020","2020",0,4,4
"Maryland","09/05/2020","2020",1,3,4
"Maryland","07/05/2020","2020",0,4,4
"Maryland","07/04/2020","2020",1,3,4
"Maryland","07/03/2020","2020",0,4,4
"Maryland","06/13/2020","2020",0,5,5
"Maryland","05/07/2020","2020",0,4,4
"Maryland","04/18/2020","2020",2,2,4
"Maryland","03/28/2020","2020",1,3,4
"Maryland","03/17/2020","2020",0,7,7
"Maryland","03/08/2020","2020",1,5,6
"Massachusetts","12/26/2000","2000",7,0,7
"Massachusetts","09/28/2010","2010",4,1,5
"Massachusetts","08/17/2014","2014",0,4,4
"Massachusetts","08/02/2014","2014",0,7,7
"Massachusetts","06/25/2014","2014",0,5,5
"Massachusetts","04/06/2014","2014",0,4,4
"Massachusetts","07/04/2015","2015",1,4,5
"Massachusetts","06/27/2015","2015",1,3,4
"Massachusetts","05/24/2015","2015",0,5,5
"Massachusetts","01/23/2015","2015",0,6,6
"Massachusetts","01/08/2015","2015",1,3,4
"Massachusetts","08/21/2016","2016",0,4,4
"Massachusetts","06/08/2016","2016",1,3,4
"Massachusetts","03/06/2016","2016",1,6,7
"Massachusetts","12/09/2017","2017",0,4,4
"Massachusetts","06/09/2018","2018",0,4,4
"Massachusetts","10/09/2019","2019",0,5,5
"Massachusetts","10/07/2019","2019",5,0,5
"Massachusetts","08/24/2019","2019",1,3,4
"Massachusetts","07/05/2019","2019",0,6,6
"Massachusetts","05/01/2019","2019",1,3,4
"Massachusetts","12/26/2020","2020",1,5,6
"Massachusetts","10/22/2020","2020",0,4,4
"Massachusetts","08/08/2020","2020",0,5,5
"Massachusetts","07/04/2020","2020",1,4,5
"Massachusetts","07/02/2020","2020",0,4,4
"Massachusetts","06/30/2020","2020",1,3,4
"Massachusetts","05/27/2020","2020",1,4,5
"Massachusetts","04/17/2020","2020",1,4,5
"Michigan","11/14/1991","1991",5,5,10
"Michigan","03/15/2006","2006",4,0,4
"Michigan","10/18/2007","2007",4,0,4
"Michigan","09/17/2007","2007",4,1,5
"Michigan","09/29/2008","2008",4,0,4
"Michigan","07/07/2011","2011",7,2,9
"Michigan","12/04/2012","2012",4,0,4
"Michigan","12/22/2013","2013",1,3,4
"Michigan","11/30/2013","2013",0,5,5
"Michigan","11/07/2013","2013",3,7,10
"Michigan","09/22/2013","2013",2,4,6
"Michigan","09/17/2013","2013",0,4,4
"Michigan","08/03/2013","2013",0,5,5
"Michigan","07/25/2013","2013",0,4,4
"Michigan","07/14/2013","2013",0,5,5
"Michigan","07/04/2013","2013",1,6,7
"Michigan","05/25/2013","2013",1,3,4
"Michigan","05/19/2013","2013",0,4,4
"Michigan","05/15/2013","2013",1,4,5
"Michigan","03/03/2013","2013",0,4,4
"Michigan","02/22/2013","2013",0,4,4
"Michigan","12/22/2014","2014",1,3,4
"Michigan","10/16/2014","2014",1,3,4
"Michigan","10/05/2014","2014",1,5,6
"Michigan","09/11/2014","2014",1,7,8
"Michigan","09/04/2014","2014",0,5,5
"Michigan","08/27/2014","2014",1,3,4
"Michigan","06/26/2014","2014",2,2,4
"Michigan","06/07/2014","2014",1,3,4
"Michigan","05/24/2014","2014",0,4,4
"Michigan","03/01/2014","2014",0,4,4
"Michigan","01/13/2014","2014",0,4,4
"Michigan","11/08/2015","2015",0,4,4
"Michigan","09/17/2015","2015",0,4,4
"Michigan","08/09/2015","2015",1,3,4
"Michigan","07/15/2015","2015",0,4,4
"Michigan","06/28/2015","2015",0,5,5
"Michigan","06/27/2015","2015",0,4,4
"Michigan","06/20/2015","2015",1,11,12
"Michigan","05/24/2015","2015",0,7,7
"Michigan","05/07/2015","2015",0,4,4
"Michigan","04/05/2015","2015",0,4,4
"Michigan","03/01/2015","2015",1,5,6
"Michigan","02/20/2016","2016",6,2,8
"Michigan","10/09/2016","2016",1,8,9
"Michigan","09/11/2016","2016",0,5,5
"Michigan","08/05/2016","2016",1,3,4
"Michigan","07/17/2016","2016",0,4,4
"Michigan","07/11/2016","2016",0,4,4
"Michigan","07/11/2016","2016",3,2,5
"Michigan","05/06/2016","2016",1,4,5
"Michigan","04/16/2016","2016",1,4,5
"Michigan","03/11/2016","2016",2,2,4
"Michigan","02/28/2016","2016",0,5,5
"Michigan","02/20/2016","2016",6,2,8
"Michigan","09/21/2016","2016",4,1,5
"Michigan","12/02/2017","2017",0,4,4
"Michigan","11/30/2017","2017",1,4,5
"Michigan","09/17/2017","2017",1,3,4
"Michigan","07/03/2017","2017",1,3,4
"Michigan","05/04/2017","2017",1,3,4
"Michigan","03/25/2017","2017",1,3,4
"Michigan","03/18/2017","2017",3,2,5
"Michigan","01/07/2017","2017",1,3,4
"Michigan","10/31/2018","2018",1,3,4
"Michigan","08/10/2018","2018",0,4,4
"Michigan","07/29/2018","2018",0,4,4
"Michigan","04/24/2018","2018",0,4,4
"Michigan","04/01/2018","2018",0,5,5
"Michigan","03/11/2018","2018",1,4,5
"Michigan","02/26/2018","2018",5,0,5
"Michigan","02/11/2018","2018",4,3,7
"Michigan","12/01/2019","2019",1,3,4
"Michigan","11/09/2019","2019",0,4,4
"Michigan","11/02/2019","2019",1,4,5
"Michigan","10/27/2019","2019",0,4,4
"Michigan","10/27/2019","2019",1,4,5
"Michigan","10/12/2019","2019",1,5,6
"Michigan","07/07/2019","2019",0,6,6
"Michigan","06/21/2019","2019",1,3,4
"Michigan","05/25/2019","2019",3,2,5
"Michigan","10/01/2020","2020",0,5,5
"Michigan","09/28/2020","2020",0,6,6
"Michigan","09/13/2020","2020",0,7,7
"Michigan","08/26/2020","2020",3,1,4
"Michigan","08/24/2020","2020",0,4,4
"Michigan","08/15/2020","2020",4,0,4
"Michigan","07/29/2020","2020",0,4,4
"Michigan","07/26/2020","2020",1,3,4
"Michigan","07/25/2020","2020",0,6,6
"Michigan","07/22/2020","2020",0,4,4
"Michigan","07/19/2020","2020",1,3,4
"Michigan","07/12/2020","2020",0,5,5
"Michigan","07/05/2020","2020",2,4,6
"Michigan","07/04/2020","2020",2,3,5
"Michigan","06/20/2020","2020",0,4,4
"Michigan","06/20/2020","2020",1,3,4
"Michigan","05/23/2020","2020",1,3,4
"Michigan","04/10/2020","2020",0,4,4
"Michigan","04/08/2020","2020",0,4,4
"Michigan","03/14/2020","2020",2,2,4
"Minnesota","03/21/2005","2005",10,5,15
"Minnesota","09/27/2012","2012",7,1,8
"Minnesota","11/25/2013","2013",1,3,4
"Minnesota","08/25/2013","2013",2,2,4
"Minnesota","08/09/2014","2014",1,8,9
"Minnesota","11/23/2015","2015",0,5,5
"Minnesota","09/12/2015","2015",0,6,6
"Minnesota","09/07/2015","2015",5,0,5
"Minnesota","08/26/2015","2015",0,4,4
"Minnesota","09/07/2015","2015",4,0,4
"Minnesota","10/03/2016","2016",0,4,4
"Minnesota","08/14/2016","2016",0,5,5
"Minnesota","06/11/2016","2016",0,4,4
"Minnesota","06/05/2016","2016",0,4,4
"Minnesota","05/04/2016","2016",1,7,8
"Minnesota","11/18/2017","2017",0,4,4
"Minnesota","11/03/2017","2017",0,4,4
"Minnesota","04/07/2017","2017",4,1,5
"Minnesota","01/30/2017","2017",0,4,4
"Minnesota","11/01/2018","2018",0,5,5
"Minnesota","09/07/2018","2018",1,3,4
"Minnesota","05/02/2018","2018",0,5,5
"Minnesota","12/22/2019","2019",1,7,8
"Minnesota","06/28/2019","2019",0,5,5
"Minnesota","09/23/2020","2020",0,5,5
"Minnesota","08/28/2020","2020",0,4,4
"Minnesota","06/22/2020","2020",0,4,4
"Minnesota","06/21/2020","2020",0,11,11
"Minnesota","06/14/2020","2020",1,6,7
"Mississippi","07/08/2003","2003",7,8,15
"Mississippi","07/07/2013","2013",0,4,4
"Mississippi","03/07/2013","2013",2,2,4
"Mississippi","12/21/2014","2014",1,4,5
"Mississippi","09/20/2014","2014",2,2,4
"Mississippi","09/02/2014","2014",2,3,5
"Mississippi","03/30/2014","2014",0,5,5
"Mississippi","01/11/2014","2014",0,4,4
"Mississippi","08/09/2015","2015",1,3,4
"Mississippi","03/13/2015","2015",2,3,5
"Mississippi","11/23/2016","2016",0,4,4
"Mississippi","10/28/2016","2016",0,6,6
"Mississippi","08/07/2016","2016",1,3,4
"Mississippi","04/27/2016","2016",3,1,4
"Mississippi","02/20/2016","2016",2,3,5
"Mississippi","02/07/2016","2016",2,4,6
"Mississippi","12/24/2017","2017",0,5,5
"Mississippi","12/16/2017","2017",0,4,4
"Mississippi","11/24/2017","2017",1,6,7
"Mississippi","10/16/2017","2017",1,3,4
"Mississippi","07/06/2017","2017",0,4,4
"Mississippi","05/28/2017","2017",0,5,5
"Mississippi","05/27/2017","2017",8,1,9
"Mississippi","02/21/2017","2017",4,0,4
"Mississippi","02/09/2017","2017",4,0,4
"Mississippi","02/06/2017","2017",4,0,4
"Mississippi","01/20/2017","2017",1,4,5
"Mississippi","01/15/2017","2017",1,4,5
"Mississippi","01/01/2017","2017",0,5,5
"Mississippi","02/20/2017","2017",4,0,4
"Mississippi","05/20/2018","2018",1,7,8
"Mississippi","05/13/2018","2018",0,4,4
"Mississippi","01/05/2018","2018",0,6,6
"Mississippi","12/20/2019","2019",1,6,7
"Mississippi","08/12/2019","2019",0,4,4
"Mississippi","05/18/2019","2019",1,4,5
"Mississippi","04/27/2019","2019",1,3,4
"Mississippi","04/02/2019","2019",0,4,4
"Mississippi","02/16/2019","2019",5,0,5
"Mississippi","12/22/2020","2020",5,0,5
"Mississippi","12/10/2020","2020",0,5,5
"Mississippi","11/29/2020","2020",0,11,11
"Mississippi","10/24/2020","2020",2,8,10
"Mississippi","10/21/2020","2020",2,2,4
"Mississippi","08/09/2020","2020",0,4,4
"Mississippi","07/12/2020","2020",2,4,6
"Mississippi","07/05/2020","2020",0,4,4
"Mississippi","07/04/2020","2020",1,3,4
"Mississippi","06/06/2020","2020",0,5,5
"Mississippi","05/31/2020","2020",1,5,6
"Mississippi","05/26/2020","2020",0,4,4
"Mississippi","05/23/2020","2020",1,4,5
"Mississippi","04/15/2020","2020",1,3,4
"Mississippi","02/17/2020","2020",2,2,4
"Mississippi","02/01/2020","2020",0,4,4
"Mississippi","01/08/2020","2020",2,2,4
"Missouri","11/17/2006","2006",4,0,4
"Missouri","04/18/2006","2006",4,1,5
"Missouri","02/07/2008","2008",6,2,8
"Missouri","03/16/2009","2009",4,1,5
"Missouri","11/30/2010","2010",4,0,4
"Missouri","09/22/2013","2013",1,3,4
"Missouri","09/07/2013","2013",1,3,4
"Missouri","08/09/2013","2013",2,2,4
"Missouri","08/04/2013","2013",1,3,4
"Missouri","06/24/2013","2013",1,3,4
"Missouri","06/23/2013","2013",1,8,9
"Missouri","06/10/2013","2013",0,6,6
"Missouri","03/21/2013","2013",1,3,4
"Missouri","03/10/2013","2013",0,5,5
"Missouri","01/25/2013","2013",1,3,4
"Missouri","12/24/2014","2014",1,3,4
"Missouri","12/02/2014","2014",1,5,6
"Missouri","11/15/2014","2014",4,0,4
"Missouri","09/27/2014","2014",0,5,5
"Missouri","08/03/2014","2014",0,5,5
"Missouri","07/27/2014","2014",0,5,5
"Missouri","07/06/2014","2014",0,4,4
"Missouri","06/29/2014","2014",0,4,4
"Missouri","09/02/2014","2014",5,3,8
"Missouri","09/27/2015","2015",0,4,4
"Missouri","09/05/2015","2015",0,4,4
"Missouri","08/09/2015","2015",0,4,4
"Missouri","08/04/2015","2015",1,4,5
"Missouri","07/26/2015","2015",2,3,5
"Missouri","07/22/2015","2015",0,6,6
"Missouri","07/14/2015","2015",0,4,4
"Missouri","06/14/2015","2015",0,4,4
"Missouri","06/09/2015","2015",1,3,4
"Missouri","05/24/2015","2015",0,4,4
"Missouri","05/18/2015","2015",0,4,4
"Missouri","03/07/2015","2015",0,4,4
"Missouri","02/26/2015","2015",8,1,9
"Missouri","11/27/2016","2016",0,7,7
"Missouri","11/12/2016","2016",1,3,4
"Missouri","09/11/2016","2016",0,6,6
"Missouri","08/28/2016","2016",2,2,4
"Missouri","08/13/2016","2016",0,4,4
"Missouri","07/30/2016","2016",0,5,5
"Missouri","07/13/2016","2016",2,2,4
"Missouri","04/29/2016","2016",0,4,4
"Missouri","02/21/2016","2016",1,3,4
"Missouri","02/19/2016","2016",4,0,4
"Missouri","08/24/2017","2017",4,0,4
"Missouri","08/12/2017","2017",1,3,4
"Missouri","06/25/2017","2017",1,3,4
"Missouri","06/18/2017","2017",3,2,5
"Missouri","06/13/2017","2017",0,4,4
"Missouri","06/03/2017","2017",2,2,4
"Missouri","06/01/2017","2017",3,1,4
"Missouri","03/24/2017","2017",1,6,7
"Missouri","02/12/2017","2017",1,6,7
"Missouri","01/12/2017","2017",3,2,5
"Missouri","08/24/2017","2017",4,0,4
"Missouri","12/28/2018","2018",4,1,5
"Missouri","12/23/2018","2018",1,6,7
"Missouri","11/21/2018","2018",0,4,4
"Missouri","11/01/2018","2018",3,2,5
"Missouri","10/13/2018","2018",0,4,4
"Missouri","08/22/2018","2018",0,4,4
"Missouri","08/10/2018","2018",0,4,4
"Missouri","08/04/2018","2018",0,6,6
"Missouri","07/03/2018","2018",1,5,6
"Missouri","05/11/2018","2018",0,4,4
"Missouri","05/09/2018","2018",0,4,4
"Missouri","04/25/2018","2018",3,1,4
"Missouri","01/31/2018","2018",0,4,4
"Missouri","01/11/2018","2018",2,2,4
"Missouri","12/28/2018","2018",4,1,5
"Missouri","12/12/2019","2019",1,3,4
"Missouri","11/10/2019","2019",0,4,4
"Missouri","10/05/2019","2019",0,5,5
"Missouri","10/03/2019","2019",1,3,4
"Missouri","10/01/2019","2019",0,4,4
"Missouri","09/22/2019","2019",0,5,5
"Missouri","09/14/2019","2019",1,3,4
"Missouri","08/23/2019","2019",1,3,4
"Missouri","08/18/2019","2019",0,4,4
"Missouri","08/07/2019","2019",3,1,4
"Missouri","07/07/2019","2019",0,5,5
"Missouri","07/06/2019","2019",5,0,5
"Missouri","07/02/2019","2019",0,4,4
"Missouri","05/27/2019","2019",2,2,4
"Missouri","05/13/2019","2019",4,1,5
"Missouri","05/10/2019","2019",0,6,6
"Missouri","05/04/2019","2019",1,4,5
"Missouri","04/09/2019","2019",1,3,4
"Missouri","07/06/2019","2019",5,0,5
"Missouri","05/13/2019","2019",4,1,5
"Missouri","03/16/2020","2020",4,0,4
"Missouri","11/14/2020","2020",0,4,4
"Missouri","11/04/2020","2020",0,4,4
"Missouri","10/10/2020","2020",2,2,4
"Missouri","09/26/2020","2020",0,5,5
"Missouri","09/06/2020","2020",0,6,6
"Missouri","09/06/2020","2020",1,3,4
"Missouri","08/04/2020","2020",1,3,4
"Missouri","07/29/2020","2020",3,2,5
"Missouri","07/14/2020","2020",0,5,5
"Missouri","07/05/2020","2020",2,3,5
"Missouri","06/13/2020","2020",2,4,6
"Missouri","06/07/2020","2020",2,7,9
"Missouri","06/06/2020","2020",1,4,5
"Missouri","06/01/2020","2020",0,4,4
"Missouri","05/24/2020","2020",0,4,4
"Missouri","05/09/2020","2020",0,4,4
"Missouri","03/20/2020","2020",0,4,4
"Missouri","03/15/2020","2020",5,2,7
"Missouri","02/29/2020","2020",1,4,5
"Missouri","01/26/2020","2020",0,5,5
"Missouri","01/19/2020","2020",2,15,17
"Missouri","01/01/2020","2020",3,2,5
"Montana","06/07/2015","2015",5,0,5
"Montana","08/04/2017","2017",3,2,5
"Montana","12/17/2019","2019",4,1,5
"Montana","03/14/2019","2019",1,3,4
"Nebraska","12/05/2007","2007",9,4,13
"Nebraska","01/28/2007","2007",4,0,4
"Nebraska","10/02/2013","2013",0,4,4
"Nebraska","12/06/2015","2015",2,3,5
"Nebraska","05/28/2015","2015",0,4,4
"Nebraska","01/24/2015","2015",3,5,8
"Nebraska","06/02/2018","2018",1,6,7
"Nebraska","05/12/2018","2018",0,6,6
"Nebraska","05/09/2018","2018",0,4,4
"Nebraska","05/18/2019","2019",0,4,4
"Nebraska","11/21/2020","2020",2,2,4
"Nebraska","07/19/2020","2020",0,8,8
"Nevada","09/06/2011","2011",5,7,12
"Nevada","09/17/2013","2013",0,4,4
"Nevada","11/18/2014","2014",0,4,4
"Nevada","08/17/2014","2014",0,4,4
"Nevada","07/20/2014","2014",1,3,4
"Nevada","02/15/2014","2014",0,5,5
"Nevada","09/05/2015","2015",1,3,4
"Nevada","06/29/2016","2016",5,0,5
"Nevada","05/29/2016","2016",0,4,4
"Nevada","04/23/2016","2016",1,3,4
"Nevada","10/01/2017","2017",58,546,604
"Nevada","12/27/2017","2017",2,2,4
"Nevada","12/22/2018","2018",0,4,4
"Nevada","10/14/2018","2018",3,1,4
"Nevada","10/12/2018","2018",0,4,4
"Nevada","08/04/2018","2018",0,6,6
"Nevada","07/05/2019","2019",1,5,6
"Nevada","03/25/2019","2019",0,5,5
"Nevada","03/17/2019","2019",0,4,4
"Nevada","11/26/2020","2020",1,5,6
"Nevada","11/03/2020","2020",4,1,5
"Nevada","10/31/2020","2020",0,4,4
"Nevada","08/29/2020","2020",2,2,4
"New Jersey","09/08/2008","2008",4,0,4
"New Jersey","09/01/2008","2008",4,0,4
"New Jersey","12/25/2013","2013",3,2,5
"New Jersey","12/21/2013","2013",1,4,5
"New Jersey","08/18/2013","2013",0,4,4
"New Jersey","08/06/2013","2013",0,4,4
"New Jersey","08/02/2013","2013",2,3,5
"New Jersey","07/13/2013","2013",1,4,5
"New Jersey","05/11/2013","2013",0,4,4
"New Jersey","05/02/2013","2013",0,5,5
"New Jersey","12/16/2014","2014",0,4,4
"New Jersey","11/29/2014","2014",1,3,4
"New Jersey","08/16/2014","2014",1,3,4
"New Jersey","07/21/2014","2014",0,6,6
"New Jersey","06/09/2014","2014",0,6,6
"New Jersey","01/21/2014","2014",2,3,5
"New Jersey","09/15/2015","2015",0,4,4
"New Jersey","07/12/2015","2015",0,4,4
"New Jersey","07/05/2015","2015",1,3,4
"New Jersey","06/14/2015","2015",1,3,4
"New Jersey","05/10/2015","2015",0,4,4
"New Jersey","05/10/2015","2015",1,3,4
"New Jersey","04/25/2015","2015",0,4,4
"New Jersey","04/18/2015","2015",1,3,4
"New Jersey","03/18/2015","2015",1,3,4
"New Jersey","12/02/2016","2016",0,6,6
"New Jersey","11/03/2016","2016",2,2,4
"New Jersey","09/11/2016","2016",1,3,4
"New Jersey","08/29/2016","2016",1,5,6
"New Jersey","08/25/2016","2016",0,5,5
"New Jersey","06/21/2016","2016",0,4,4
"New Jersey","05/29/2016","2016",0,6,6
"New Jersey","05/23/2016","2016",0,5,5
"New Jersey","03/11/2016","2016",0,5,5
"New Jersey","12/31/2017","2017",4,0,4
"New Jersey","09/24/2017","2017",1,3,4
"New Jersey","08/21/2017","2017",0,4,4
"New Jersey","08/05/2017","2017",0,4,4
"New Jersey","07/18/2017","2017",1,3,4
"New Jersey","07/02/2017","2017",0,4,4
"New Jersey","07/01/2017","2017",2,2,4
"New Jersey","06/24/2017","2017",0,4,4
"New Jersey","05/28/2017","2017",1,5,6
"New Jersey","05/10/2017","2017",1,3,4
"New Jersey","04/27/2017","2017",1,3,4
"New Jersey","01/11/2017","2017",1,3,4
"New Jersey","10/26/2018","2018",1,3,4
"New Jersey","09/02/2018","2018",2,2,4
"New Jersey","09/02/2018","2018",0,4,4
"New Jersey","08/08/2018","2018",0,4,4
"New Jersey","07/20/2018","2018",0,4,4
"New Jersey","06/30/2018","2018",0,5,5
"New Jersey","06/17/2018","2018",1,19,20
"New Jersey","05/12/2018","2018",0,4,4
"New Jersey","03/31/2018","2018",0,5,5
"New Jersey","03/29/2018","2018",0,4,4
"New Jersey","11/20/2018","2018",4,0,4
"New Jersey","12/10/2019","2019",4,3,7
"New Jersey","11/18/2019","2019",1,4,5
"New Jersey","06/28/2019","2019",0,4,4
"New Jersey","06/28/2019","2019",0,4,4
"New Jersey","06/18/2019","2019",1,4,5
"New Jersey","05/27/2019","2019",1,5,6
"New Jersey","05/25/2019","2019",0,9,9
"New Jersey","05/05/2019","2019",1,4,5
"New Jersey","03/16/2019","2019",1,3,4
"New Jersey","03/11/2019","2019",0,4,4
"New Jersey","01/26/2019","2019",1,3,4
"New Jersey","11/22/2020","2020",0,4,4
"New Jersey","11/01/2020","2020",1,4,5
"New Jersey","10/28/2020","2020",1,3,4
"New Jersey","09/19/2020","2020",0,4,4
"New Jersey","09/19/2020","2020",0,5,5
"New Jersey","09/13/2020","2020",2,7,9
"New Jersey","08/12/2020","2020",1,4,5
"New Jersey","08/02/2020","2020",0,5,5
"New Jersey","07/07/2020","2020",4,3,7
"New Jersey","07/02/2020","2020",1,4,5
"New Jersey","06/20/2020","2020",1,4,5
"New Jersey","05/30/2020","2020",0,4,4
"New Jersey","07/07/2020","2020",4,3,7
"New Mexico","07/30/2013","2013",0,4,4
"New Mexico","01/19/2013","2013",5,0,5
"New Mexico","08/08/2014","2014",1,3,4
"New Mexico","08/22/2015","2015",3,1,4
"New Mexico","03/22/2015","2015",1,6,7
"New Mexico","12/05/2016","2016",4,1,5
"New Mexico","08/08/2016","2016",2,2,4
"New Mexico","06/11/2016","2016",5,0,5
"New Mexico","04/09/2016","2016",0,4,4
"New Mexico","08/28/2017","2017",2,4,6
"New Mexico","06/15/2017","2017",5,0,5
"New Mexico","11/13/2018","2018",4,1,5
"New Mexico","10/04/2018","2018",1,3,4
"New Mexico","09/12/2019","2019",1,4,5
"New Mexico","08/25/2019","2019",3,4,7
"New Mexico","07/07/2019","2019",0,4,4
"New Mexico","01/06/2019","2019",0,4,4
"New Mexico","05/14/2020","2020",0,5,5
"New Mexico","03/14/2020","2020",1,3,4
"New Mexico","03/07/2020","2020",0,4,4
"New York","10/15/1992","1992",5,0,5
"New York","12/07/1993","1993",6,19,25
"New York","01/19/2007","2007",5,0,5
"New York","04/03/2009","2009",14,4,18
"New York","02/14/2009","2009",4,1,5
"New York","08/14/2010","2010",4,4,8
"New York","06/19/2011","2011",4,0,4
"New York","03/13/2013","2013",5,2,7
"New York","12/31/2013","2013",0,6,6
"New York","12/25/2013","2013",1,3,4
"New York","11/28/2013","2013",0,4,4
"New York","11/11/2013","2013",4,1,5
"New York","10/05/2013","2013",0,4,4
"New York","09/11/2013","2013",0,4,4
"New York","08/11/2013","2013",0,4,4
"New York","07/21/2013","2013",0,4,4
"New York","07/20/2013","2013",0,5,5
"New York","07/06/2013","2013",1,3,4
"New York","06/30/2013","2013",0,9,9
"New York","04/07/2013","2013",1,3,4
"New York","03/22/2013","2013",1,3,4
"New York","03/13/2013","2013",5,2,7
"New York","03/13/2013","2013",4,2,6
"New York","12/22/2014","2014",4,2,6
"New York","11/30/2014","2014",0,4,4
"New York","10/18/2014","2014",0,4,4
"New York","10/18/2014","2014",0,4,4
"New York","10/11/2014","2014",0,5,5
"New York","10/08/2014","2014",4,0,4
"New York","09/19/2014","2014",0,4,4
"New York","08/17/2014","2014",0,4,4
"New York","08/12/2014","2014",1,3,4
"New York","07/06/2014","2014",0,4,4
"New York","06/28/2014","2014",0,4,4
"New York","04/27/2014","2014",0,5,5
"New York","03/14/2014","2014",0,4,4
"New York","01/03/2014","2014",1,3,4
"New York","11/22/2015","2015",0,5,5
"New York","09/12/2015","2015",2,4,6
"New York","08/28/2015","2015",1,3,4
"New York","08/19/2015","2015",3,4,7
"New York","08/03/2015","2015",0,5,5
"New York","08/02/2015","2015",0,9,9
"New York","07/20/2015","2015",0,6,6
"New York","07/04/2015","2015",0,4,4
"New York","06/24/2015","2015",0,4,4
"New York","06/15/2015","2015",0,4,4
"New York","06/13/2015","2015",0,5,5
"New York","06/06/2015","2015",1,4,5
"New York","06/03/2015","2015",3,1,4
"New York","05/16/2015","2015",0,4,4
"New York","05/04/2015","2015",1,3,4
"New York","05/03/2015","2015",0,4,4
"New York","04/27/2015","2015",2,4,6
"New York","04/25/2015","2015",1,6,7
"New York","02/01/2015","2015",0,6,6
"New York","02/01/2015","2015",1,4,5
"New York","01/24/2015","2015",4,1,5
"New York","12/25/2016","2016",1,5,6
"New York","12/11/2016","2016",0,4,4
"New York","11/24/2016","2016",1,3,4
"New York","10/30/2016","2016",0,4,4
"New York","10/30/2016","2016",2,5,7
"New York","10/08/2016","2016",0,4,4
"New York","08/28/2016","2016",0,4,4
"New York","08/13/2016","2016",0,4,4
"New York","07/28/2016","2016",0,5,5
"New York","07/23/2016","2016",0,4,4
"New York","07/04/2016","2016",0,7,7
"New York","06/13/2016","2016",0,5,5
"New York","06/05/2016","2016",0,4,4
"New York","04/23/2016","2016",0,4,4
"New York","02/07/2016","2016",1,7,8
"New York","04/11/2016","2016",4,0,4
"New York","01/11/2016","2016",4,0,4
"New York","11/03/2017","2017",0,4,4
"New York","10/17/2017","2017",0,4,4
"New York","09/24/2017","2017",0,4,4
"New York","08/20/2017","2017",0,4,4
"New York","08/16/2017","2017",0,4,4
"New York","08/06/2017","2017",0,6,6
"New York","07/29/2017","2017",1,4,5
"New York","06/30/2017","2017",2,6,8
"New York","06/24/2017","2017",0,5,5
"New York","05/27/2017","2017",0,4,4
"New York","02/22/2017","2017",0,4,4
"New York","02/12/2017","2017",1,3,4
"New York","12/08/2018","2018",0,5,5
"New York","11/03/2018","2018",0,5,5
"New York","09/22/2018","2018",0,4,4
"New York","09/20/2018","2018",0,5,5
"New York","08/18/2018","2018",0,4,4
"New York","07/05/2018","2018",0,4,4
"New York","07/05/2018","2018",0,4,4
"New York","07/02/2018","2018",2,2,4
"New York","06/14/2018","2018",1,4,5
"New York","06/12/2018","2018",0,4,4
"New York","06/02/2018","2018",0,5,5
"New York","05/02/2018","2018",1,4,5
"New York","03/03/2018","2018",1,3,4
"New York","12/29/2019","2019",1,3,4
"New York","11/27/2019","2019",0,5,5
"New York","10/12/2019","2019",4,3,7
"New York","08/05/2019","2019",0,4,4
"New York","07/27/2019","2019",1,11,12
"New York","07/05/2019","2019",0,4,4
"New York","06/30/2019","2019",0,6,6
"New York","06/09/2019","2019",0,4,4
"New York","02/06/2019","2019",1,3,4
"New York","12/12/2020","2020",2,2,4
"New York","12/12/2020","2020",0,4,4
"New York","11/22/2020","2020",1,6,7
"New York","10/21/2020","2020",1,5,6
"New York","10/17/2020","2020",1,5,6
"New York","10/07/2020","2020",1,3,4
"New York","09/20/2020","2020",0,4,4
"New York","09/19/2020","2020",1,4,5
"New York","09/19/2020","2020",2,14,16
"New York","09/07/2020","2020",0,5,5
"New York","08/30/2020","2020",1,4,5
"New York","08/25/2020","2020",0,4,4
"New York","08/23/2020","2020",1,3,4
"New York","08/18/2020","2020",0,4,4
"New York","08/17/2020","2020",0,4,4
"New York","08/15/2020","2020",0,5,5
"New York","08/14/2020","2020",0,4,4
"New York","08/08/2020","2020",1,3,4
"New York","08/03/2020","2020",0,4,4
"New York","07/15/2020","2020",1,5,6
"New York","07/13/2020","2020",0,6,6
"New York","07/12/2020","2020",1,3,4
"New York","07/11/2020","2020",0,6,6
"New York","07/05/2020","2020",0,5,5
"New York","06/27/2020","2020",0,4,4
"New York","06/22/2020","2020",0,5,5
"New York","06/21/2020","2020",0,4,4
"New York","06/20/2020","2020",0,4,4
"New York","06/20/2020","2020",1,8,9
"New York","06/18/2020","2020",0,7,7
"New York","06/13/2020","2020",1,7,8
"New York","06/12/2020","2020",1,3,4
"New York","06/08/2020","2020",0,4,4
"New York","04/26/2020","2020",0,4,4
"New York","04/05/2020","2020",0,4,4
"New York","01/26/2020","2020",3,1,4
"New York","01/02/2020","2020",0,4,4
"North Carolina","08/06/1993","1993",4,8,12
"North Carolina","03/24/2008","2008",4,0,4
"North Carolina","03/29/2009","2009",8,3,11
"North Carolina","11/01/2009","2009",4,0,4
"North Carolina","03/12/2009","2009",4,0,4
"North Carolina","11/20/2011","2011",5,1,6
"North Carolina","12/21/2013","2013",0,4,4
"North Carolina","12/14/2013","2013",0,4,4
"North Carolina","10/27/2013","2013",1,4,5
"North Carolina","09/25/2013","2013",0,4,4
"North Carolina","09/14/2013","2013",0,4,4
"North Carolina","09/05/2013","2013",0,4,4
"North Carolina","07/11/2013","2013",2,2,4
"North Carolina","06/21/2013","2013",0,5,5
"North Carolina","06/14/2013","2013",0,5,5
"North Carolina","05/04/2013","2013",0,4,4
"North Carolina","04/28/2013","2013",0,5,5
"North Carolina","07/30/2014","2014",3,4,7
"North Carolina","03/30/2014","2014",0,5,5
"North Carolina","01/27/2014","2014",0,4,4
"North Carolina","12/20/2015","2015",1,4,5
"North Carolina","10/25/2015","2015",0,5,5
"North Carolina","10/10/2015","2015",0,4,4
"North Carolina","09/11/2015","2015",0,5,5
"North Carolina","09/05/2015","2015",1,3,4
"North Carolina","08/21/2015","2015",0,8,8
"North Carolina","08/08/2015","2015",2,3,5
"North Carolina","07/19/2015","2015",0,4,4
"North Carolina","06/20/2015","2015",0,4,4
"North Carolina","04/18/2015","2015",1,3,4
"North Carolina","04/18/2015","2015",0,4,4
"North Carolina","01/11/2015","2015",2,5,7
"North Carolina","12/24/2016","2016",0,7,7
"North Carolina","12/24/2016","2016",4,0,4
"North Carolina","12/17/2016","2016",0,4,4
"North Carolina","12/11/2016","2016",0,4,4
"North Carolina","09/26/2016","2016",0,4,4
"North Carolina","09/11/2016","2016",0,5,5
"North Carolina","09/03/2016","2016",1,3,4
"North Carolina","06/26/2016","2016",0,5,5
"North Carolina","06/11/2016","2016",1,3,4
"North Carolina","11/11/2017","2017",1,5,6
"North Carolina","08/21/2017","2017",4,0,4
"North Carolina","07/29/2017","2017",2,3,5
"North Carolina","07/26/2017","2017",1,6,7
"North Carolina","07/04/2017","2017",1,3,4
"North Carolina","04/16/2017","2017",0,4,4
"North Carolina","04/07/2017","2017",3,1,4
"North Carolina","11/12/2018","2018",3,1,4
"North Carolina","06/24/2018","2018",1,6,7
"North Carolina","06/17/2018","2018",0,4,4
"North Carolina","06/09/2018","2018",0,4,4
"North Carolina","05/04/2018","2018",0,4,4
"North Carolina","04/29/2018","2018",1,3,4
"North Carolina","04/28/2018","2018",0,5,5
"North Carolina","04/18/2018","2018",4,3,7
"North Carolina","04/08/2018","2018",1,3,4
"North Carolina","03/09/2018","2018",3,1,4
"North Carolina","12/24/2019","2019",0,6,6
"North Carolina","11/08/2019","2019",1,3,4
"North Carolina","10/03/2019","2019",1,3,4
"North Carolina","09/07/2019","2019",3,1,4
"North Carolina","09/02/2019","2019",2,2,4
"North Carolina","09/01/2019","2019",0,4,4
"North Carolina","08/31/2019","2019",1,3,4
"North Carolina","06/12/2019","2019",1,3,4
"North Carolina","05/18/2019","2019",2,4,6
"North Carolina","04/30/2019","2019",2,4,6
"North Carolina","04/07/2019","2019",0,7,7
"North Carolina","12/05/2020","2020",0,6,6
"North Carolina","11/12/2020","2020",0,6,6
"North Carolina","11/01/2020","2020",1,3,4
"North Carolina","10/25/2020","2020",1,3,4
"North Carolina","09/30/2020","2020",0,4,4
"North Carolina","09/12/2020","2020",0,5,5
"North Carolina","07/25/2020","2020",0,4,4
"North Carolina","07/14/2020","2020",0,8,8
"North Carolina","06/22/2020","2020",4,5,9
"North Carolina","06/20/2020","2020",2,2,4
"North Carolina","06/09/2020","2020",0,5,5
"North Carolina","05/30/2020","2020",1,5,6
"North Carolina","05/23/2020","2020",0,6,6
"North Carolina","04/26/2020","2020",1,4,5
"North Carolina","04/17/2020","2020",1,3,4
"North Carolina","03/15/2020","2020",7,0,7
"North Carolina","02/23/2020","2020",3,1,4
"North Carolina","02/20/2020","2020",0,4,4
"North Carolina","01/26/2020","2020",0,6,6
"North Carolina","01/24/2020","2020",5,0,5
"North Dakota","01/28/2011","2011",4,0,4
"North Dakota","11/18/2012","2012",4,1,5
"North Dakota","04/01/2019","2019",4,0,4
"Ohio","12/08/2004","2004",5,7,12
"Ohio","06/21/2006","2006",4,0,4
"Ohio","01/29/2007","2007",4,0,4
"Ohio","03/05/2009","2009",5,1,6
"Ohio","08/07/2011","2011",7,1,8
"Ohio","04/30/2011","2011",4,4,8
"Ohio","04/16/2011","2011",4,0,4
"Ohio","07/06/2012","2012",4,0,4
"Ohio","11/10/2013","2013",1,3,4
"Ohio","09/27/2013","2013",0,4,4
"Ohio","08/18/2013","2013",0,4,4
"Ohio","07/13/2013","2013",0,4,4
"Ohio","05/13/2013","2013",0,4,4
"Ohio","04/25/2013","2013",0,4,4
"Ohio","04/18/2013","2013",4,0,4
"Ohio","01/26/2013","2013",1,3,4
"Ohio","11/22/2014","2014",4,1,5
"Ohio","11/22/2014","2014",1,3,4
"Ohio","11/16/2014","2014",1,4,5
"Ohio","09/21/2014","2014",0,4,4
"Ohio","05/25/2014","2014",1,3,4
"Ohio","05/18/2014","2014",0,7,7
"Ohio","03/09/2014","2014",3,1,4
"Ohio","11/21/2014","2014",4,1,5
"Ohio","12/08/2015","2015",1,3,4
"Ohio","11/23/2015","2015",4,1,5
"Ohio","09/28/2015","2015",0,4,4
"Ohio","09/28/2015","2015",0,5,5
"Ohio","08/21/2015","2015",2,5,7
"Ohio","07/17/2015","2015",0,4,4
"Ohio","07/15/2015","2015",0,7,7
"Ohio","07/07/2015","2015",1,3,4
"Ohio","06/13/2015","2015",4,1,5
"Ohio","05/31/2015","2015",3,1,4
"Ohio","05/10/2015","2015",1,4,5
"Ohio","05/07/2015","2015",0,4,4
"Ohio","05/03/2015","2015",1,6,7
"Ohio","02/05/2015","2015",3,3,6
"Ohio","12/30/2016","2016",0,5,5
"Ohio","10/30/2016","2016",0,4,4
"Ohio","10/29/2016","2016",1,3,4
"Ohio","10/25/2016","2016",1,3,4
"Ohio","07/24/2016","2016",1,7,8
"Ohio","07/23/2016","2016",2,2,4
"Ohio","07/16/2016","2016",0,5,5
"Ohio","07/14/2016","2016",1,3,4
"Ohio","07/04/2016","2016",0,4,4
"Ohio","04/22/2016","2016",8,0,8
"Ohio","03/04/2016","2016",1,3,4
"Ohio","12/13/2017","2017",1,3,4
"Ohio","11/24/2017","2017",1,5,6
"Ohio","11/10/2017","2017",0,4,4
"Ohio","11/04/2017","2017",0,4,4
"Ohio","10/28/2017","2017",0,4,4
"Ohio","10/11/2017","2017",4,0,4
"Ohio","08/19/2017","2017",1,4,5
"Ohio","07/22/2017","2017",0,5,5
"Ohio","07/08/2017","2017",1,8,9
"Ohio","06/17/2017","2017",1,4,5
"Ohio","06/14/2017","2017",0,4,4
"Ohio","05/30/2017","2017",1,3,4
"Ohio","04/16/2017","2017",0,9,9
"Ohio","03/26/2017","2017",2,2,4
"Ohio","03/26/2017","2017",2,15,17
"Ohio","03/25/2017","2017",2,2,4
"Ohio","02/28/2017","2017",0,6,6
"Ohio","02/25/2017","2017",2,3,5
"Ohio","02/21/2017","2017",0,4,4
"Ohio","02/20/2017","2017",0,5,5
"Ohio","02/08/2017","2017",1,4,5
"Ohio","09/06/2018","2018",3,2,5
"Ohio","12/31/2018","2018",3,2,5
"Ohio","12/29/2018","2018",1,3,4
"Ohio","09/01/2018","2018",1,7,8
"Ohio","08/20/2018","2018",1,3,4
"Ohio","08/11/2018","2018",0,4,4
"Ohio","07/26/2018","2018",1,6,7
"Ohio","07/05/2018","2018",1,5,6
"Ohio","06/24/2018","2018",0,5,5
"Ohio","05/25/2018","2018",0,4,4
"Ohio","02/03/2018","2018",1,5,6
"Ohio","08/04/2019","2019",9,27,36
"Ohio","11/17/2019","2019",0,4,4
"Ohio","11/03/2019","2019",0,4,4
"Ohio","10/15/2019","2019",0,4,4
"Ohio","10/13/2019","2019",0,4,4
"Ohio","09/21/2019","2019",4,0,4
"Ohio","09/01/2019","2019",0,4,4
"Ohio","07/30/2019","2019",0,5,5
"Ohio","06/26/2019","2019",1,3,4
"Ohio","06/23/2019","2019",0,5,5
"Ohio","06/09/2019","2019",1,3,4
"Ohio","05/20/2019","2019",0,4,4
"Ohio","05/16/2019","2019",0,4,4
"Ohio","04/28/2019","2019",4,0,4
"Ohio","07/09/2019","2019",4,0,4
"Ohio","11/27/2020","2020",0,6,6
"Ohio","11/14/2020","2020",0,4,4
"Ohio","11/05/2020","2020",3,2,5
"Ohio","11/02/2020","2020",0,5,5
"Ohio","10/19/2020","2020",0,5,5
"Ohio","09/29/2020","2020",2,2,4
"Ohio","09/27/2020","2020",1,3,4
"Ohio","09/21/2020","2020",1,4,5
"Ohio","08/17/2020","2020",0,5,5
"Ohio","08/16/2020","2020",1,3,4
"Ohio","08/12/2020","2020",1,3,4
"Ohio","08/09/2020","2020",0,6,6
"Ohio","07/29/2020","2020",5,0,5
"Ohio","07/17/2020","2020",0,4,4
"Ohio","06/30/2020","2020",0,4,4
"Ohio","06/22/2020","2020",1,4,5
"Ohio","06/10/2020","2020",1,3,4
"Ohio","06/06/2020","2020",0,4,4
"Ohio","05/27/2020","2020",1,3,4
"Ohio","05/22/2020","2020",1,3,4
"Ohio","05/03/2020","2020",0,4,4
"Ohio","03/07/2020","2020",1,18,19
"Ohio","01/01/2020","2020",0,4,4
"Ohio","07/28/2020","2020",4,0,4
"Oklahoma","11/09/2009","2009",4,1,5
"Oklahoma","11/23/2013","2013",4,1,5
"Oklahoma","10/12/2013","2013",0,5,5
"Oklahoma","08/14/2013","2013",4,0,4
"Oklahoma","07/13/2013","2013",1,3,4
"Oklahoma","02/21/2013","2013",1,3,4
"Oklahoma","01/07/2013","2013",4,0,4
"Oklahoma","04/06/2014","2014",0,4,4
"Oklahoma","01/16/2014","2014",2,4,6
"Oklahoma","09/20/2015","2015",0,6,6
"Oklahoma","06/14/2015","2015",0,4,4
"Oklahoma","06/13/2015","2015",0,4,4
"Oklahoma","03/20/2015","2015",0,4,4
"Oklahoma","02/06/2015","2015",1,4,5
"Oklahoma","10/23/2016","2016",1,5,6
"Oklahoma","04/01/2017","2017",2,3,5
"Oklahoma","10/06/2018","2018",0,4,4
"Oklahoma","07/18/2018","2018",0,4,4
"Oklahoma","05/11/2018","2018",1,4,5
"Oklahoma","05/06/2018","2018",0,4,4
"Oklahoma","02/16/2018","2018",1,3,4
"Oklahoma","10/24/2019","2019",2,2,4
"Oklahoma","10/22/2019","2019",1,3,4
"Oklahoma","05/25/2019","2019",0,5,5
"Oklahoma","05/20/2019","2019",2,2,4
"Oklahoma","11/01/2020","2020",1,3,4
"Oklahoma","08/16/2020","2020",0,4,4
"Oregon","05/21/1998","1998",4,25,29
"Oregon","05/22/2012","2012",5,0,5
"Oregon","12/12/2014","2014",0,4,4
"Oregon","07/05/2014","2014",1,4,5
"Oregon","10/01/2015","2015",9,9,18
"Oregon","07/18/2015","2015",1,4,5
"Oregon","06/27/2016","2016",3,1,4
"Oregon","03/12/2016","2016",0,4,4
"Oregon","01/03/2017","2017",4,0,4
"Oregon","05/19/2019","2019",0,5,5
"Oregon","12/31/2020","2020",0,4,4
"Oregon","08/27/2020","2020",1,3,4
"Pennsylvania","10/02/2006","2006",6,5,11
"Pennsylvania","10/02/2006","2006",5,5,10
"Pennsylvania","07/22/2007","2007",4,0,4
"Pennsylvania","11/21/2013","2013",0,4,4
"Pennsylvania","10/21/2013","2013",2,5,7
"Pennsylvania","10/13/2013","2013",0,8,8
"Pennsylvania","10/06/2013","2013",1,5,6
"Pennsylvania","08/13/2013","2013",0,4,4
"Pennsylvania","08/06/2013","2013",3,4,7
"Pennsylvania","06/09/2013","2013",0,4,4
"Pennsylvania","05/16/2013","2013",0,4,4
"Pennsylvania","05/11/2013","2013",0,4,4
"Pennsylvania","05/06/2013","2013",0,4,4
"Pennsylvania","04/28/2013","2013",1,3,4
"Pennsylvania","04/09/2013","2013",1,3,4
"Pennsylvania","01/01/2013","2013",0,4,4
"Pennsylvania","12/15/2014","2014",7,0,7
"Pennsylvania","11/21/2014","2014",0,6,6
"Pennsylvania","09/28/2014","2014",0,4,4
"Pennsylvania","08/02/2014","2014",1,5,6
"Pennsylvania","08/01/2014","2014",1,3,4
"Pennsylvania","07/28/2014","2014",1,4,5
"Pennsylvania","07/23/2014","2014",0,4,4
"Pennsylvania","07/02/2014","2014",0,5,5
"Pennsylvania","03/01/2014","2014",1,4,5
"Pennsylvania","01/05/2014","2014",1,3,4
"Pennsylvania","12/15/2014","2014",6,1,7
"Pennsylvania","12/26/2015","2015",0,4,4
"Pennsylvania","12/11/2015","2015",0,4,4
"Pennsylvania","11/20/2015","2015",1,3,4
"Pennsylvania","11/15/2015","2015",0,4,4
"Pennsylvania","11/14/2015","2015",0,4,4
"Pennsylvania","09/20/2015","2015",1,3,4
"Pennsylvania","08/15/2015","2015",1,3,4
"Pennsylvania","07/30/2015","2015",0,4,4
"Pennsylvania","07/24/2015","2015",2,5,7
"Pennsylvania","06/22/2015","2015",0,7,7
"Pennsylvania","06/20/2015","2015",0,10,10
"Pennsylvania","05/28/2015","2015",1,3,4
"Pennsylvania","04/18/2015","2015",0,5,5
"Pennsylvania","04/05/2015","2015",1,3,4
"Pennsylvania","11/04/2016","2016",0,4,4
"Pennsylvania","09/18/2016","2016",0,4,4
"Pennsylvania","09/18/2016","2016",0,4,4
"Pennsylvania","09/16/2016","2016",2,5,7
"Pennsylvania","09/05/2016","2016",0,4,4
"Pennsylvania","08/11/2016","2016",0,4,4
"Pennsylvania","08/06/2016","2016",5,0,5
"Pennsylvania","07/04/2016","2016",0,4,4
"Pennsylvania","04/17/2016","2016",3,1,4
"Pennsylvania","03/09/2016","2016",6,2,8
"Pennsylvania","08/06/2016","2016",4,0,4
"Pennsylvania","03/09/2016","2016",5,3,8
"Pennsylvania","12/21/2017","2017",1,3,4
"Pennsylvania","12/04/2017","2017",2,2,4
"Pennsylvania","11/09/2017","2017",0,4,4
"Pennsylvania","10/21/2017","2017",0,4,4
"Pennsylvania","09/26/2017","2017",1,3,4
"Pennsylvania","09/24/2017","2017",0,4,4
"Pennsylvania","09/13/2017","2017",0,4,4
"Pennsylvania","09/13/2017","2017",0,4,4
"Pennsylvania","08/13/2017","2017",0,5,5
"Pennsylvania","07/15/2017","2017",1,3,4
"Pennsylvania","05/20/2017","2017",0,10,10
"Pennsylvania","04/28/2017","2017",0,4,4
"Pennsylvania","04/15/2017","2017",0,4,4
"Pennsylvania","04/03/2017","2017",3,1,4
"Pennsylvania","03/03/2017","2017",0,4,4
"Pennsylvania","02/18/2017","2017",0,4,4
"Pennsylvania","10/27/2018","2018",11,6,17
"Pennsylvania","01/28/2018","2018",4,1,5
"Pennsylvania","12/13/2018","2018",0,4,4
"Pennsylvania","11/19/2018","2018",4,0,4
"Pennsylvania","10/03/2018","2018",1,4,5
"Pennsylvania","09/28/2018","2018",2,2,4
"Pennsylvania","09/19/2018","2018",1,4,5
"Pennsylvania","08/23/2018","2018",0,4,4
"Pennsylvania","08/14/2018","2018",0,5,5
"Pennsylvania","08/12/2018","2018",0,4,4
"Pennsylvania","08/08/2018","2018",2,4,6
"Pennsylvania","07/29/2018","2018",0,4,4
"Pennsylvania","07/16/2018","2018",1,4,5
"Pennsylvania","06/22/2018","2018",1,3,4
"Pennsylvania","06/14/2018","2018",0,4,4
"Pennsylvania","06/09/2018","2018",1,4,5
"Pennsylvania","04/21/2018","2018",2,2,4
"Pennsylvania","01/28/2018","2018",4,0,4
"Pennsylvania","01/23/2018","2018",0,4,4
"Pennsylvania","01/24/2019","2019",3,1,4
"Pennsylvania","10/30/2019","2019",4,0,4
"Pennsylvania","10/19/2019","2019",0,4,4
"Pennsylvania","10/13/2019","2019",0,6,6
"Pennsylvania","10/12/2019","2019",1,3,4
"Pennsylvania","10/10/2019","2019",0,5,5
"Pennsylvania","08/31/2019","2019",2,2,4
"Pennsylvania","08/15/2019","2019",0,5,5
"Pennsylvania","08/14/2019","2019",0,6,6
"Pennsylvania","07/28/2019","2019",1,5,6
"Pennsylvania","07/20/2019","2019",0,4,4
"Pennsylvania","07/13/2019","2019",0,7,7
"Pennsylvania","06/22/2019","2019",0,4,4
"Pennsylvania","06/20/2019","2019",0,10,10
"Pennsylvania","06/16/2019","2019",1,5,6
"Pennsylvania","05/11/2019","2019",0,4,4
"Pennsylvania","05/10/2019","2019",0,5,5
"Pennsylvania","04/21/2019","2019",0,4,4
"Pennsylvania","01/19/2019","2019",0,4,4
"Pennsylvania","12/01/2020","2020",1,3,4
"Pennsylvania","10/14/2020","2020",0,4,4
"Pennsylvania","10/08/2020","2020",1,6,7
"Pennsylvania","09/29/2020","2020",0,5,5
"Pennsylvania","09/26/2020","2020",0,4,4
"Pennsylvania","09/25/2020","2020",0,4,4
"Pennsylvania","09/16/2020","2020",2,3,5
"Pennsylvania","09/12/2020","2020",0,4,4
"Pennsylvania","09/03/2020","2020",0,6,6
"Pennsylvania","09/02/2020","2020",2,2,4
"Pennsylvania","08/31/2020","2020",0,5,5
"Pennsylvania","08/30/2020","2020",0,4,4
"Pennsylvania","08/28/2020","2020",1,3,4
"Pennsylvania","08/26/2020","2020",0,4,4
"Pennsylvania","08/19/2020","2020",0,4,4
"Pennsylvania","08/18/2020","2020",1,4,5
"Pennsylvania","08/15/2020","2020",0,5,5
"Pennsylvania","08/08/2020","2020",0,6,6
"Pennsylvania","08/02/2020","2020",0,4,4
"Pennsylvania","07/31/2020","2020",1,3,4
"Pennsylvania","07/05/2020","2020",0,4,4
"Pennsylvania","06/28/2020","2020",2,2,4
"Pennsylvania","06/25/2020","2020",0,4,4
"Pennsylvania","06/12/2020","2020",0,6,6
"Pennsylvania","06/09/2020","2020",1,6,7
"Pennsylvania","05/31/2020","2020",0,4,4
"Pennsylvania","05/28/2020","2020",1,3,4
"Pennsylvania","05/27/2020","2020",0,4,4
"Pennsylvania","05/26/2020","2020",0,4,4
"Pennsylvania","05/15/2020","2020",0,4,4
"Pennsylvania","05/02/2020","2020",0,4,4
"Pennsylvania","04/16/2020","2020",0,4,4
"Pennsylvania","03/30/2020","2020",0,5,5
"Pennsylvania","03/10/2020","2020",2,2,4
"Rhode Island","06/22/2013","2013",0,4,4
"Rhode Island","06/15/2013","2013",1,3,4
"Rhode Island","07/08/2014","2014",0,5,5
"Rhode Island","06/19/2015","2015",0,4,4
"South Carolina","09/15/1997","1997",4,3,7
"South Carolina","09/30/2006","2006",5,0,5
"South Carolina","04/26/2008","2008",4,0,4
"South Carolina","10/14/2011","2011",4,0,4
"South Carolina","07/03/2011","2011",4,0,4
"South Carolina","10/29/2013","2013",5,0,5
"South Carolina","08/25/2013","2013",1,3,4
"South Carolina","08/18/2013","2013",1,4,5
"South Carolina","06/29/2013","2013",3,1,4
"South Carolina","04/06/2013","2013",1,4,5
"South Carolina","10/29/2013","2013",5,0,5
"South Carolina","10/18/2014","2014",1,3,4
"South Carolina","09/29/2014","2014",1,7,8
"South Carolina","09/26/2014","2014",1,4,5
"South Carolina","06/07/2014","2014",1,5,6
"South Carolina","05/24/2014","2014",3,1,4
"South Carolina","03/21/2014","2014",0,4,4
"South Carolina","03/05/2014","2014",3,1,4
"South Carolina","06/17/2015","2015",9,1,10
"South Carolina","11/24/2015","2015",0,4,4
"South Carolina","11/22/2015","2015",1,3,4
"South Carolina","11/02/2015","2015",4,0,4
"South Carolina","10/24/2015","2015",0,4,4
"South Carolina","08/16/2015","2015",0,5,5
"South Carolina","08/15/2015","2015",1,3,4
"South Carolina","08/06/2015","2015",0,4,4
"South Carolina","07/15/2015","2015",4,1,5
"South Carolina","03/08/2015","2015",1,3,4
"South Carolina","02/22/2015","2015",0,4,4
"South Carolina","11/01/2015","2015",4,0,4
"South Carolina","11/05/2016","2016",0,5,5
"South Carolina","07/23/2016","2016",0,4,4
"South Carolina","06/26/2016","2016",0,4,4
"South Carolina","05/17/2016","2016",3,1,4
"South Carolina","04/17/2016","2016",1,3,4
"South Carolina","09/16/2017","2017",0,8,8
"South Carolina","08/05/2017","2017",1,3,4
"South Carolina","07/02/2017","2017",0,4,4
"South Carolina","06/18/2017","2017",0,7,7
"South Carolina","05/16/2017","2017",3,1,4
"South Carolina","04/30/2017","2017",1,5,6
"South Carolina","02/07/2017","2017",0,4,4
"South Carolina","10/12/2018","2018",0,6,6
"South Carolina","10/03/2018","2018",2,6,8
"South Carolina","08/15/2018","2018",0,5,5
"South Carolina","05/31/2018","2018",3,2,5
"South Carolina","10/21/2019","2019",0,4,4
"South Carolina","09/21/2019","2019",2,8,10
"South Carolina","09/08/2019","2019",2,2,4
"South Carolina","08/31/2019","2019",0,4,4
"South Carolina","08/22/2019","2019",2,2,4
"South Carolina","06/23/2019","2019",3,1,4
"South Carolina","06/01/2019","2019",0,5,5
"South Carolina","03/31/2019","2019",0,7,7
"South Carolina","01/19/2019","2019",1,4,5
"South Carolina","01/01/2019","2019",0,5,5
"South Carolina","11/28/2020","2020",1,10,11
"South Carolina","11/28/2020","2020",0,5,5
"South Carolina","11/18/2020","2020",0,4,4
"South Carolina","11/14/2020","2020",3,1,4
"South Carolina","11/07/2020","2020",1,3,4
"South Carolina","11/01/2020","2020",0,6,6
"South Carolina","10/17/2020","2020",0,5,5
"South Carolina","10/12/2020","2020",2,3,5
"South Carolina","10/10/2020","2020",0,8,8
"South Carolina","09/03/2020","2020",1,3,4
"South Carolina","08/26/2020","2020",0,4,4
"South Carolina","07/05/2020","2020",2,8,10
"South Carolina","07/04/2020","2020",0,5,5
"South Carolina","05/26/2020","2020",3,5,8
"South Carolina","05/24/2020","2020",0,4,4
"South Carolina","05/23/2020","2020",2,5,7
"South Carolina","05/17/2020","2020",0,4,4
"South Carolina","05/17/2020","2020",4,1,5
"South Carolina","04/08/2020","2020",1,3,4
"South Carolina","04/05/2020","2020",1,4,5
"South Carolina","03/22/2020","2020",0,4,4
"South Carolina","01/26/2020","2020",3,3,6
"South Dakota","11/22/2014","2014",4,1,5
"South Dakota","09/17/2015","2015",6,0,6
"South Dakota","09/17/2015","2015",5,0,5
"South Dakota","06/29/2020","2020",1,3,4
"Tennessee","03/02/2008","2008",6,3,9
"Tennessee","02/27/2008","2008",4,1,5
"Tennessee","10/22/2012","2012",5,0,5
"Tennessee","09/18/2013","2013",1,4,5
"Tennessee","09/12/2013","2013",4,0,4
"Tennessee","06/23/2013","2013",1,3,4
"Tennessee","06/15/2013","2013",0,4,4
"Tennessee","05/28/2013","2013",1,3,4
"Tennessee","05/23/2013","2013",2,2,4
"Tennessee","05/19/2013","2013",2,2,4
"Tennessee","04/28/2013","2013",2,2,4
"Tennessee","02/02/2013","2013",0,5,5
"Tennessee","01/23/2013","2013",1,3,4
"Tennessee","09/11/2013","2013",4,0,4
"Tennessee","11/30/2014","2014",0,5,5
"Tennessee","11/28/2014","2014",0,4,4
"Tennessee","10/29/2014","2014",0,5,5
"Tennessee","10/04/2014","2014",2,2,4
"Tennessee","08/20/2014","2014",0,5,5
"Tennessee","08/14/2014","2014",1,3,4
"Tennessee","08/13/2014","2014",0,4,4
"Tennessee","08/03/2014","2014",0,5,5
"Tennessee","07/21/2014","2014",0,4,4
"Tennessee","06/21/2014","2014",0,5,5
"Tennessee","05/11/2014","2014",0,7,7
"Tennessee","04/25/2014","2014",2,3,5
"Tennessee","04/09/2014","2014",3,1,4
"Tennessee","07/16/2015","2015",5,2,7
"Tennessee","12/27/2015","2015",0,4,4
"Tennessee","10/22/2015","2015",1,3,4
"Tennessee","10/10/2015","2015",0,6,6
"Tennessee","08/30/2015","2015",1,4,5
"Tennessee","08/29/2015","2015",3,2,5
"Tennessee","03/23/2015","2015",1,4,5
"Tennessee","02/08/2015","2015",0,6,6
"Tennessee","01/20/2015","2015",1,3,4
"Tennessee","01/07/2015","2015",1,3,4
"Tennessee","01/01/2015","2015",0,5,5
"Tennessee","11/17/2016","2016",1,7,8
"Tennessee","11/09/2016","2016",0,4,4
"Tennessee","11/01/2016","2016",1,5,6
"Tennessee","08/04/2016","2016",0,4,4
"Tennessee","07/16/2016","2016",0,6,6
"Tennessee","07/07/2016","2016",1,4,5
"Tennessee","07/03/2016","2016",0,4,4
"Tennessee","05/22/2016","2016",0,4,4
"Tennessee","05/01/2016","2016",0,5,5
"Tennessee","04/25/2016","2016",0,4,4
"Tennessee","04/09/2016","2016",0,4,4
"Tennessee","01/07/2016","2016",1,3,4
"Tennessee","12/03/2017","2017",1,3,4
"Tennessee","10/21/2017","2017",0,4,4
"Tennessee","09/30/2017","2017",1,3,4
"Tennessee","09/26/2017","2017",0,4,4
"Tennessee","09/24/2017","2017",1,8,9
"Tennessee","09/13/2017","2017",1,5,6
"Tennessee","08/21/2017","2017",0,4,4
"Tennessee","06/11/2017","2017",0,4,4
"Tennessee","06/10/2017","2017",0,4,4
"Tennessee","03/25/2017","2017",1,4,5
"Tennessee","02/11/2017","2017",0,4,4
"Tennessee","01/31/2017","2017",0,4,4
"Tennessee","01/27/2017","2017",0,10,10
"Tennessee","01/21/2017","2017",2,2,4
"Tennessee","04/22/2018","2018",4,4,8
"Tennessee","11/26/2018","2018",0,4,4
"Tennessee","10/27/2018","2018",0,5,5
"Tennessee","10/15/2018","2018",5,0,5
"Tennessee","09/24/2018","2018",3,2,5
"Tennessee","09/18/2018","2018",0,4,4
"Tennessee","09/10/2018","2018",0,5,5
"Tennessee","08/25/2018","2018",1,4,5
"Tennessee","08/21/2018","2018",0,4,4
"Tennessee","08/20/2018","2018",1,4,5
"Tennessee","07/15/2018","2018",0,5,5
"Tennessee","07/12/2018","2018",0,5,5
"Tennessee","07/08/2018","2018",0,4,4
"Tennessee","06/23/2018","2018",0,4,4
"Tennessee","05/06/2018","2018",2,4,6
"Tennessee","04/29/2018","2018",0,4,4
"Tennessee","04/22/2018","2018",4,3,7
"Tennessee","02/17/2018","2018",0,5,5
"Tennessee","01/12/2018","2018",3,2,5
"Tennessee","11/10/2019","2019",1,4,5
"Tennessee","08/04/2019","2019",1,3,4
"Tennessee","06/17/2019","2019",0,5,5
"Tennessee","06/09/2019","2019",1,3,4
"Tennessee","04/28/2019","2019",0,7,7
"Tennessee","04/20/2019","2019",0,6,6
"Tennessee","02/20/2019","2019",0,4,4
"Tennessee","11/29/2020","2020",2,3,5
"Tennessee","11/17/2020","2020",0,4,4
"Tennessee","11/08/2020","2020",0,8,8
"Tennessee","10/18/2020","2020",0,4,4
"Tennessee","10/03/2020","2020",0,5,5
"Tennessee","09/27/2020","2020",0,4,4
"Tennessee","09/13/2020","2020",3,3,6
"Tennessee","09/06/2020","2020",0,4,4
"Tennessee","08/23/2020","2020",1,4,5
"Tennessee","07/16/2020","2020",0,5,5
"Tennessee","06/24/2020","2020",0,4,4
"Tennessee","06/08/2020","2020",0,4,4
"Tennessee","06/07/2020","2020",0,5,5
"Tennessee","05/28/2020","2020",0,4,4
"Tennessee","05/13/2020","2020",0,4,4
"Tennessee","05/06/2020","2020",2,2,4
"Tennessee","04/25/2020","2020",0,7,7
"Tennessee","02/15/2020","2020",0,7,7
"Tennessee","01/19/2020","2020",1,4,5
"Texas","10/16/1991","1991",24,20,44
"Texas","04/03/1995","1995",6,0,6
"Texas","09/15/1999","1999",8,7,15
"Texas","08/24/2007","2007",6,0,6
"Texas","12/06/2008","2008",4,1,5
"Texas","06/01/2008","2008",4,0,4
"Texas","05/10/2008","2008",4,0,4
"Texas","11/05/2009","2009",13,31,44
"Texas","11/05/2009","2009",13,32,45
"Texas","01/17/2010","2010",5,0,5
"Texas","12/25/2011","2011",6,0,6
"Texas","11/30/2011","2011",4,1,5
"Texas","07/23/2011","2011",5,4,9
"Texas","12/15/2013","2013",0,5,5
"Texas","11/20/2013","2013",3,2,5
"Texas","11/15/2013","2013",1,3,4
"Texas","11/09/2013","2013",2,16,18
"Texas","10/27/2013","2013",0,4,4
"Texas","10/09/2013","2013",4,0,4
"Texas","09/20/2013","2013",5,0,5
"Texas","08/07/2013","2013",4,4,8
"Texas","07/28/2013","2013",0,4,4
"Texas","07/01/2013","2013",4,0,4
"Texas","06/15/2013","2013",1,3,4
"Texas","10/28/2013","2013",5,0,5
"Texas","04/03/2014","2014",3,12,15
"Texas","11/27/2014","2014",2,3,5
"Texas","11/16/2014","2014",0,6,6
"Texas","09/14/2014","2014",3,1,4
"Texas","09/14/2014","2014",3,1,4
"Texas","08/03/2014","2014",0,7,7
"Texas","08/02/2014","2014",3,1,4
"Texas","07/09/2014","2014",6,1,7
"Texas","07/05/2014","2014",0,6,6
"Texas","05/21/2014","2014",1,3,4
"Texas","05/03/2014","2014",0,6,6
"Texas","04/02/2014","2014",4,16,20
"Texas","03/23/2014","2014",1,3,4
"Texas","03/16/2014","2014",3,1,4
"Texas","03/09/2014","2014",0,6,6
"Texas","02/16/2014","2014",1,7,8
"Texas","02/16/2014","2014",1,4,5
"Texas","01/30/2014","2014",4,0,4
"Texas","01/25/2014","2014",4,0,4
"Texas","11/22/2015","2015",0,4,4
"Texas","11/15/2015","2015",5,0,5
"Texas","10/27/2015","2015",0,5,5
"Texas","08/29/2015","2015",1,3,4
"Texas","08/16/2015","2015",0,6,6
"Texas","08/08/2015","2015",8,0,8
"Texas","07/16/2015","2015",0,5,5
"Texas","07/04/2015","2015",0,4,4
"Texas","06/11/2015","2015",1,3,4
"Texas","05/17/2015","2015",9,18,27
"Texas","05/03/2015","2015",0,6,6
"Texas","04/21/2015","2015",2,3,5
"Texas","03/26/2015","2015",0,4,4
"Texas","03/20/2015","2015",1,5,6
"Texas","02/25/2015","2015",3,1,4
"Texas","02/22/2015","2015",4,1,5
"Texas","01/19/2015","2015",2,5,7
"Texas","01/04/2015","2015",3,1,4
"Texas","11/14/2015","2015",6,1,7
"Texas","07/07/2016","2016",5,11,16
"Texas","12/31/2016","2016",1,3,4
"Texas","12/09/2016","2016",4,0,4
"Texas","11/28/2016","2016",1,3,4
"Texas","11/13/2016","2016",0,4,4
"Texas","11/11/2016","2016",0,4,4
"Texas","11/10/2016","2016",1,3,4
"Texas","11/05/2016","2016",0,4,4
"Texas","10/30/2016","2016",0,5,5
"Texas","10/02/2016","2016",1,4,5
"Texas","09/26/2016","2016",0,4,4
"Texas","09/26/2016","2016",1,6,7
"Texas","09/14/2016","2016",1,3,4
"Texas","09/08/2016","2016",4,0,4
"Texas","08/28/2016","2016",0,6,6
"Texas","08/12/2016","2016",1,3,4
"Texas","07/31/2016","2016",1,4,5
"Texas","07/23/2016","2016",4,1,5
"Texas","07/17/2016","2016",1,3,4
"Texas","07/16/2016","2016",0,5,5
"Texas","07/14/2016","2016",3,1,4
"Texas","07/04/2016","2016",3,2,5
"Texas","06/26/2016","2016",1,3,4
"Texas","06/26/2016","2016",0,4,4
"Texas","06/25/2016","2016",2,5,7
"Texas","05/29/2016","2016",2,6,8
"Texas","05/08/2016","2016",1,3,4
"Texas","04/17/2016","2016",1,6,7
"Texas","03/08/2016","2016",2,3,5
"Texas","02/21/2016","2016",0,5,5
"Texas","02/14/2016","2016",1,3,4
"Texas","11/05/2017","2017",26,20,46
"Texas","12/12/2017","2017",0,4,4
"Texas","11/11/2017","2017",1,3,4
"Texas","11/04/2017","2017",0,4,4
"Texas","10/29/2017","2017",1,3,4
"Texas","10/15/2017","2017",2,2,4
"Texas","10/09/2017","2017",0,5,5
"Texas","09/10/2017","2017",9,1,10
"Texas","07/30/2017","2017",1,3,4
"Texas","06/11/2017","2017",0,4,4
"Texas","06/09/2017","2017",2,5,7
"Texas","06/02/2017","2017",2,3,5
"Texas","05/14/2017","2017",0,4,4
"Texas","05/01/2017","2017",2,3,5
"Texas","04/09/2017","2017",1,3,4
"Texas","04/07/2017","2017",5,0,5
"Texas","04/03/2017","2017",0,7,7
"Texas","03/26/2017","2017",2,4,6
"Texas","01/22/2017","2017",3,2,5
"Texas","01/16/2017","2017",0,4,4
"Texas","01/03/2017","2017",0,4,4
"Texas","01/01/2017","2017",1,3,4
"Texas","05/18/2018","2018",10,13,23
"Texas","11/25/2018","2018",1,3,4
"Texas","10/14/2018","2018",0,4,4
"Texas","10/13/2018","2018",4,1,5
"Texas","10/06/2018","2018",1,3,4
"Texas","09/02/2018","2018",0,4,4
"Texas","07/27/2018","2018",5,0,5
"Texas","07/26/2018","2018",0,6,6
"Texas","07/11/2018","2018",0,4,4
"Texas","06/27/2018","2018",0,4,4
"Texas","06/03/2018","2018",0,5,5
"Texas","05/16/2018","2018",5,1,6
"Texas","04/02/2018","2018",1,3,4
"Texas","03/29/2018","2018",1,3,4
"Texas","02/18/2018","2018",0,5,5
"Texas","08/31/2019","2019",7,25,32
"Texas","08/03/2019","2019",22,26,48
"Texas","12/27/2019","2019",2,7,9
"Texas","12/18/2019","2019",0,4,4
"Texas","12/08/2019","2019",2,3,5
"Texas","11/29/2019","2019",0,7,7
"Texas","11/04/2019","2019",1,4,5
"Texas","11/03/2019","2019",1,3,4
"Texas","11/01/2019","2019",0,4,4
"Texas","10/26/2019","2019",2,6,8
"Texas","10/20/2019","2019",1,3,4
"Texas","10/19/2019","2019",1,4,5
"Texas","09/29/2019","2019",4,0,4
"Texas","08/23/2019","2019",3,2,5
"Texas","08/17/2019","2019",0,6,6
"Texas","07/17/2019","2019",1,3,4
"Texas","07/16/2019","2019",0,4,4
"Texas","07/11/2019","2019",0,4,4
"Texas","07/03/2019","2019",2,3,5
"Texas","06/30/2019","2019",2,2,4
"Texas","06/17/2019","2019",0,4,4
"Texas","06/07/2019","2019",0,5,5
"Texas","05/29/2019","2019",3,2,5
"Texas","05/03/2019","2019",1,3,4
"Texas","02/21/2019","2019",2,2,4
"Texas","02/17/2019","2019",2,2,4
"Texas","02/11/2019","2019",5,0,5
"Texas","02/05/2019","2019",2,2,4
"Texas","01/28/2019","2019",2,5,7
"Texas","01/19/2019","2019",3,2,5
"Texas","12/06/2020","2020",0,6,6
"Texas","11/18/2020","2020",3,2,5
"Texas","11/09/2020","2020",0,4,4
"Texas","10/25/2020","2020",2,3,5
"Texas","10/25/2020","2020",1,3,4
"Texas","10/20/2020","2020",3,1,4
"Texas","09/05/2020","2020",0,4,4
"Texas","08/30/2020","2020",2,2,4
"Texas","08/28/2020","2020",1,4,5
"Texas","08/17/2020","2020",3,2,5
"Texas","08/09/2020","2020",0,4,4
"Texas","08/01/2020","2020",2,3,5
"Texas","07/26/2020","2020",0,4,4
"Texas","07/25/2020","2020",0,4,4
"Texas","07/05/2020","2020",0,4,4
"Texas","06/21/2020","2020",0,5,5
"Texas","06/21/2020","2020",1,3,4
"Texas","06/12/2020","2020",0,8,8
"Texas","06/11/2020","2020",2,4,6
"Texas","06/02/2020","2020",1,3,4
"Texas","05/30/2020","2020",1,4,5
"Texas","05/23/2020","2020",0,4,4
"Texas","05/20/2020","2020",2,3,5
"Texas","05/10/2020","2020",0,5,5
"Texas","05/10/2020","2020",0,6,6
"Texas","05/06/2020","2020",3,1,4
"Texas","04/24/2020","2020",3,1,4
"Texas","04/04/2020","2020",2,2,4
"Texas","04/04/2020","2020",0,4,4
"Texas","03/23/2020","2020",0,4,4
"Texas","02/23/2020","2020",0,7,7
"Texas","02/08/2020","2020",1,3,4
"Texas","01/19/2020","2020",2,5,7
"Texas","01/18/2020","2020",2,2,4
"Utah","02/12/2007","2007",6,4,10
"Utah","02/12/2013","2013",4,1,5
"Utah","08/16/2014","2014",0,6,6
"Utah","01/16/2014","2014",5,0,5
"Utah","06/06/2017","2017",3,2,5
"Utah","03/24/2018","2018",0,4,4
"Utah","01/17/2020","2020",4,1,5
"Vermont","08/07/2015","2015",4,0,4
"Vermont","08/07/2015","2015",4,0,4
"Virginia","10/05/2006","2006",4,0,4
"Virginia","04/16/2007","2007",32,23,55
"Virginia","01/19/2010","2010",8,0,8
"Virginia","12/15/2011","2011",4,0,4
"Virginia","08/27/2011","2011",4,2,6
"Virginia","08/11/2013","2013",1,4,5
"Virginia","06/23/2013","2013",1,4,5
"Virginia","06/21/2013","2013",0,6,6
"Virginia","06/02/2013","2013",0,7,7
"Virginia","05/25/2013","2013",1,4,5
"Virginia","05/18/2013","2013",0,4,4
"Virginia","12/02/2014","2014",0,5,5
"Virginia","11/23/2014","2014",0,4,4
"Virginia","08/03/2014","2014",5,0,5
"Virginia","07/05/2014","2014",0,7,7
"Virginia","07/04/2014","2014",0,5,5
"Virginia","02/25/2014","2014",4,1,5
"Virginia","01/20/2014","2014",0,4,4
"Virginia","01/01/2014","2014",2,2,4
"Virginia","07/25/2015","2015",0,4,4
"Virginia","07/19/2015","2015",0,4,4
"Virginia","04/19/2015","2015",0,4,4
"Virginia","01/13/2015","2015",0,5,5
"Virginia","01/04/2015","2015",2,4,6
"Virginia","10/25/2016","2016",2,3,5
"Virginia","09/18/2016","2016",1,3,4
"Virginia","09/04/2016","2016",1,10,11
"Virginia","08/14/2016","2016",0,4,4
"Virginia","06/25/2016","2016",0,4,4
"Virginia","06/19/2016","2016",0,4,4
"Virginia","06/18/2016","2016",1,3,4
"Virginia","04/24/2016","2016",0,5,5
"Virginia","02/27/2016","2016",2,2,4
"Virginia","01/27/2016","2016",6,0,6
"Virginia","01/17/2016","2016",1,3,4
"Virginia","10/28/2017","2017",1,3,4
"Virginia","09/17/2017","2017",1,4,5
"Virginia","08/13/2017","2017",0,4,4
"Virginia","07/30/2017","2017",1,5,6
"Virginia","07/19/2017","2017",0,5,5
"Virginia","07/09/2017","2017",0,7,7
"Virginia","07/04/2017","2017",1,4,5
"Virginia","06/15/2017","2017",1,3,4
"Virginia","06/14/2017","2017",1,5,6
"Virginia","04/29/2017","2017",0,4,4
"Virginia","02/27/2017","2017",0,4,4
"Virginia","02/19/2017","2017",1,3,4
"Virginia","08/25/2018","2018",0,5,5
"Virginia","07/13/2018","2018",1,3,4
"Virginia","07/05/2018","2018",0,6,6
"Virginia","04/06/2018","2018",1,3,4
"Virginia","05/31/2019","2019",12,4,16
"Virginia","12/25/2019","2019",1,3,4
"Virginia","08/10/2019","2019",0,4,4
"Virginia","08/02/2019","2019",2,3,5
"Virginia","06/22/2019","2019",0,4,4
"Virginia","06/01/2019","2019",1,3,4
"Virginia","05/26/2019","2019",0,5,5
"Virginia","05/25/2019","2019",1,9,10
"Virginia","02/09/2019","2019",0,4,4
"Virginia","01/04/2019","2019",3,2,5
"Virginia","11/08/2020","2020",0,4,4
"Virginia","10/28/2020","2020",0,4,4
"Virginia","08/25/2020","2020",0,5,5
"Virginia","08/24/2020","2020",1,4,5
"Virginia","07/23/2020","2020",1,3,4
"Virginia","07/23/2020","2020",0,4,4
"Virginia","07/20/2020","2020",1,4,5
"Virginia","07/07/2020","2020",0,5,5
"Virginia","06/11/2020","2020",0,4,4
"Virginia","05/29/2020","2020",0,5,5
"Virginia","03/20/2020","2020",0,4,4
"Washington","06/20/1994","1994",5,23,28
"Washington","03/25/2006","2006",7,2,9
"Washington","12/24/2007","2007",6,0,6
"Washington","09/02/2008","2008",6,4,10
"Washington","11/29/2009","2009",4,1,5
"Washington","04/04/2009","2009",5,0,5
"Washington","05/20/2012","2012",6,1,7
"Washington","05/30/2012","2012",5,1,6
"Washington","04/21/2013","2013",5,0,5
"Washington","09/15/2013","2013",0,6,6
"Washington","07/29/2013","2013",0,4,4
"Washington","03/31/2013","2013",3,2,5
"Washington","04/22/2013","2013",4,0,4
"Washington","10/24/2014","2014",5,1,6
"Washington","07/13/2014","2014",0,5,5
"Washington","01/27/2014","2014",1,4,5
"Washington","11/22/2015","2015",0,4,4
"Washington","09/23/2016","2016",5,0,5
"Washington","11/09/2016","2016",0,5,5
"Washington","08/20/2016","2016",0,5,5
"Washington","07/30/2016","2016",3,1,4
"Washington","07/15/2016","2016",3,1,4
"Washington","06/22/2016","2016",3,1,4
"Washington","02/26/2016","2016",5,0,5
"Washington","01/26/2016","2016",2,3,5
"Washington","09/13/2017","2017",1,3,4
"Washington","08/01/2017","2017",0,6,6
"Washington","01/27/2017","2017",4,0,4
"Washington","10/21/2018","2018",1,3,4
"Washington","07/20/2018","2018",1,4,5
"Washington","04/29/2018","2018",2,2,4
"Washington","11/21/2019","2019",0,4,4
"Washington","08/13/2019","2019",2,3,5
"Washington","07/26/2019","2019",1,3,4
"Washington","06/08/2019","2019",5,2,7
"Washington","10/31/2020","2020",0,5,5
"Washington","10/02/2020","2020",0,4,4
"Washington","07/27/2020","2020",1,3,4
"Washington","07/13/2020","2020",0,6,6
"Washington","01/22/2020","2020",1,7,8
"West Virginia","09/05/2011","2011",5,2,7
"West Virginia","05/19/2012","2012",4,0,4
"West Virginia","09/24/2013","2013",0,6,6
"West Virginia","07/26/2013","2013",4,0,4
"West Virginia","12/01/2014","2014",4,0,4
"West Virginia","05/14/2016","2016",1,3,4
"West Virginia","12/13/2020","2020",4,0,4
"West Virginia","12/08/2020","2020",6,0,6
"West Virginia","01/01/2020","2020",0,7,7
"Wisconsin","03/12/2005","2005",7,4,11
"Wisconsin","10/07/2007","2007",6,1,7
"Wisconsin","06/09/2007","2007",5,1,6
"Wisconsin","07/04/2008","2008",4,2,6
"Wisconsin","12/03/2009","2009",4,0,4
"Wisconsin","08/05/2012","2012",7,3,10
"Wisconsin","06/01/2013","2013",0,4,4
"Wisconsin","08/08/2014","2014",0,4,4
"Wisconsin","06/26/2014","2014",0,5,5
"Wisconsin","06/11/2015","2015",3,1,4
"Wisconsin","05/16/2015","2015",0,5,5
"Wisconsin","05/03/2015","2015",4,1,5
"Wisconsin","05/01/2015","2015",2,3,5
"Wisconsin","08/13/2016","2016",2,2,4
"Wisconsin","04/10/2016","2016",1,3,4
"Wisconsin","07/18/2017","2017",0,4,4
"Wisconsin","03/22/2017","2017",5,0,5
"Wisconsin","12/09/2018","2018",0,4,4
"Wisconsin","09/19/2018","2018",1,4,5
"Wisconsin","09/15/2018","2018",0,4,4
"Wisconsin","08/04/2018","2018",0,4,4
"Wisconsin","09/29/2019","2019",0,4,4
"Wisconsin","07/28/2019","2019",5,2,7
"Wisconsin","06/26/2019","2019",0,4,4
"Wisconsin","07/28/2019","2019",4,2,6
"Wisconsin","02/26/2020","2020",5,0,5
"Wisconsin","11/20/2020","2020",0,8,8
"Wisconsin","09/30/2020","2020",0,7,7
"Wisconsin","08/04/2020","2020",0,4,4
"Wisconsin","07/28/2020","2020",0,4,4
"Wisconsin","07/05/2020","2020",0,4,4
"Wisconsin","06/21/2020","2020",0,5,5
"Wisconsin","06/20/2020","2020",0,5,5
"Wisconsin","06/02/2020","2020",0,5,5
"Wisconsin","04/27/2020","2020",5,0,5
"Wyoming","07/07/2011","2011",4,1,5
"Wyoming","09/16/2019","2019",2,2,4
